sep=,
"Nombre","Saldo actual","Cuentas","Transferencias","Descripción","Beneficiario","Categoría","Fecha","Hora","Memoria","Importe","Moneda","Número de cheque","Etiquetas","Saldo"
"Roboadvisor","4595,19","EUR","","","","","","","","","","","",""
"","","Roboadvisor","","Roboadvisor","","Pasivos > Activos financieros > Roboadvisor","11/05/2025","11:37","","126,21","EUR","","Pablo; ","4595,19"
"","","Roboadvisor","","Roboadvisor","","Inversiones Ingresos > Roboadvisor","01/05/2025","11:21","","30,00","EUR","","Pablo; ","4468,98"
"","","Roboadvisor","","Roboadvisor","","Pasivos > Activos financieros > Roboadvisor","30/04/2025","22:57","","234,87","EUR","","Pablo; ","4438,98"
"","","Roboadvisor","","Roboadvisor","","Inversiones Ingresos > Roboadvisor","24/04/2025","19:28","","30,00","EUR","","Pablo; ","4204,11"
"","","Roboadvisor","","Roboadvisor","","Inversiones Ingresos > Roboadvisor","17/04/2025","8:56","","30,00","EUR","","Pablo; ","4174,11"
"","","Roboadvisor","","Roboadvisor","","Pasivos > Activos financieros > Roboadvisor","13/04/2025","22:36","","-452,85","EUR","","Pablo; ","4144,11"
"","","Roboadvisor","","Roboadvisor","","Inversiones Ingresos > Roboadvisor","10/04/2025","22:27","","30,00","EUR","","Pablo; ","4596,96"
"","","Roboadvisor","","Roboadvisor","","Inversiones Ingresos > Roboadvisor","03/04/2025","22:13","","30,00","EUR","","Pablo; ","4566,96"
"","","Roboadvisor","","Roboadvisor","","Pasivos > Activos financieros > Roboadvisor","30/03/2025","13:40","","-42,29","EUR","","Pablo; ","4536,96"
"","","Roboadvisor","","Roboadvisor","","Inversiones Ingresos > Roboadvisor","27/03/2025","13:42","","30,00","EUR","","Pablo; ","4579,25"
"","","Roboadvisor","","Roboadvisor","","Pasivos > Activos financieros > Roboadvisor","23/03/2025","8:14","","81,36","EUR","","Pablo; ","4549,25"
"","","Roboadvisor","","Roboadvisor","","Inversiones Ingresos > Roboadvisor","20/03/2025","10:33","","30,00","EUR","","Pablo; ","4467,89"
"","","Roboadvisor","","Roboadvisor","","Inversiones Ingresos > Roboadvisor","17/03/2025","22:38","","30,00","EUR","","Pablo; ","4437,89"
"","","Roboadvisor","","Roboadvisor","","Pasivos > Activos financieros > Roboadvisor","15/03/2025","22:49","","-114,30","EUR","","Pablo; ","4407,89"
"","","Roboadvisor","","Roboadvisor","","Pasivos > Activos financieros > Roboadvisor","08/03/2025","20:56","","-199,20","EUR","","Pablo; ","4522,19"
"","","Roboadvisor","","Roboadvisor","","Inversiones Ingresos > Roboadvisor","06/03/2025","18:37","","30,00","EUR","","Pablo; ","4721,39"
"","","Roboadvisor","","Roboadvisor","","Pasivos > Activos financieros > Roboadvisor","28/02/2025","8:27","","-69,35","EUR","","Pablo; ","4691,39"
"","","Roboadvisor","","Roboadvisor","","Inversiones Ingresos > Roboadvisor","27/02/2025","23:48","","30,00","EUR","","Pablo; ","4760,74"
"","","Roboadvisor","","Roboadvisor","","Inversiones Ingresos > Roboadvisor","20/02/2025","12:46","","30,00","EUR","","Pablo; ","4730,74"
"","","Roboadvisor","","Roboadvisor","","Pasivos > Activos financieros > Roboadvisor","15/02/2025","0:38","","46,19","EUR","","Pablo; ","4700,74"
"","","Roboadvisor","","Roboadvisor","","Inversiones Ingresos > Roboadvisor","13/02/2025","11:21","","30,00","EUR","","Pablo; ","4654,55"
"","","Roboadvisor","","Roboadvisor","","Inversiones Ingresos > Roboadvisor","06/02/2025","8:38","","30,00","EUR","","Pablo; ","4624,55"
"","","Roboadvisor","","Roboadvisor","","Pasivos > Activos financieros > Roboadvisor","31/01/2025","20:46","","0,86","EUR","","Pablo; ","4594,55"
"","","Roboadvisor","","Roboadvisor","","Inversiones Ingresos > Roboadvisor","31/01/2025","9:03","","30,00","EUR","","Pablo; ","4593,69"
"","","Roboadvisor","","Roboadvisor","","Pasivos > Activos financieros > Roboadvisor","26/01/2025","21:14","","68,11","EUR","","Pablo; ","4563,69"
"","","Roboadvisor","","Roboadvisor","","Inversiones Ingresos > Roboadvisor","23/01/2025","23:41","","30,00","EUR","","Pablo; ","4495,58"
"","","Roboadvisor","","Roboadvisor","","Pasivos > Activos financieros > Roboadvisor","18/01/2025","10:21","","30,71","EUR","","Pablo; ","4465,58"
"","","Roboadvisor","","Roboadvisor","","Inversiones Ingresos > Roboadvisor","16/01/2025","8:56","","30,00","EUR","","Pablo; ","4434,87"
"","","Roboadvisor","","Roboadvisor","","Pasivos > Activos financieros > Roboadvisor","12/01/2025","10:52","","-24,16","EUR","","Pablo; ","4404,87"
"","","Roboadvisor","","Roboadvisor","","Inversiones Ingresos > Roboadvisor","09/01/2025","10:34","","30,00","EUR","","Pablo; ","4429,03"
"","","Roboadvisor","","Roboadvisor","","Pasivos > Activos financieros > Roboadvisor","05/01/2025","9:45","","-7,68","EUR","","Pablo; ","4399,03"
"","","Roboadvisor","","Roboadvisor","","Inversiones Ingresos > Roboadvisor","02/01/2025","10:03","","30,00","EUR","","Pablo; ","4406,71"
"","","Roboadvisor","","Roboadvisor","","Inversiones Ingresos > Roboadvisor","28/12/2024","20:03","","85,00","EUR","","Pablo; ","4376,71"
"","","Roboadvisor","","Roboadvisor","","Pasivos > Activos financieros > Roboadvisor","28/12/2024","19:31","","-12,36","EUR","","Pablo; ","4291,71"
"","","Roboadvisor","","Roboadvisor","","Inversiones Ingresos > Roboadvisor","23/12/2024","9:07","","20,00","EUR","","Pablo; ","4304,07"
"","","Roboadvisor","","Roboadvisor","","Pasivos > Activos financieros > Roboadvisor","22/12/2024","11:13","","-47,09","EUR","","Pablo; ","4284,07"
"","","Roboadvisor","","Roboadvisor","","Inversiones Ingresos > Roboadvisor","15/12/2024","17:02","","20,00","EUR","","Pablo; ","4331,16"
"","","Roboadvisor","","Roboadvisor","","Pasivos > Activos financieros > Roboadvisor","15/12/2024","11:31","","-36,49","EUR","","Pablo; ","4311,16"
"","","Roboadvisor","","Roboadvisor","","Inversiones Ingresos > Roboadvisor","09/12/2024","22:56","","20,00","EUR","","Pablo; ","4347,65"
"","","Roboadvisor","","Roboadvisor","","Pasivos > Activos financieros > Roboadvisor","09/12/2024","17:54","","20,47","EUR","","Pablo; ","4327,65"
"","","Roboadvisor","","Roboadvisor","","Inversiones Ingresos > Roboadvisor","02/12/2024","18:07","","20,00","EUR","","Pablo; ","4307,18"
"","","Roboadvisor","","Roboadvisor","","Pasivos > Activos financieros > Roboadvisor","02/12/2024","17:51","","58,01","EUR","","Pablo; ","4287,18"
"","","Roboadvisor","","Roboadvisor","","Inversiones Ingresos > Roboadvisor","25/11/2024","19:20","","20,00","EUR","","Pablo; ","4229,17"
"","","Roboadvisor","","Roboadvisor","","Pasivos > Activos financieros > Roboadvisor","24/11/2024","19:34","","4,90","EUR","","Pablo; ","4209,17"
"","","Roboadvisor","","Roboadvisor","","Inversiones Ingresos > Roboadvisor","17/11/2024","22:19","","20,00","EUR","","Pablo; ","4204,27"
"","","Roboadvisor","","Roboadvisor","","Pasivos > Activos financieros > Roboadvisor","17/11/2024","20:08","","-2,42","EUR","","Pablo; ","4184,27"
"","","Roboadvisor","","Roboadvisor","","Inversiones Ingresos > Roboadvisor","10/11/2024","22:17","","40,00","EUR","","Pablo; ","4186,69"
"","","Roboadvisor","","Roboadvisor","","Pasivos > Activos financieros > Roboadvisor","09/11/2024","13:35","","31,24","EUR","","Pablo; ","4146,69"
"","","Roboadvisor","","Roboadvisor","","Pasivos > Activos financieros > Roboadvisor","01/11/2024","18:01","","-22,85","EUR","","Pablo; ","4115,45"
"","","Roboadvisor","","Roboadvisor","","Pasivos > Activos financieros > Roboadvisor","27/10/2024","19:22","","-33,00","EUR","","Pablo; ","4138,30"
"","","Roboadvisor","","Roboadvisor","","Pasivos > Activos financieros > Roboadvisor","19/10/2024","15:33","","22,90","EUR","","Pablo; ","4171,30"
"","","Roboadvisor","","Roboadvisor","","Pasivos > Activos financieros > Roboadvisor","12/10/2024","21:42","","-17,73","EUR","","Pablo; ","4148,40"
"","","Roboadvisor","","Roboadvisor","","Pasivos > Activos financieros > Roboadvisor","05/10/2024","15:07","","5,55","EUR","","Pablo; ","4166,13"
"","","Roboadvisor","","Roboadvisor","","Pasivos > Activos financieros > Roboadvisor","28/09/2024","12:38","","1,28","EUR","","Pablo; ","4160,58"
"","","Roboadvisor","","Roboadvisor","","Pasivos > Activos financieros > Roboadvisor","21/09/2024","19:12","","4,85","EUR","","Pablo; ","4159,30"
"","","Roboadvisor","","Roboadvisor","","Pasivos > Activos financieros > Roboadvisor","14/09/2024","22:17","","37,36","EUR","","Pablo; ","4154,45"
"","","Roboadvisor","","Roboadvisor","","Pasivos > Activos financieros > Roboadvisor","01/09/2024","18:18","","0,18","EUR","","Pablo; ","4117,09"
"","","Roboadvisor","","Roboadvisor","","Pasivos > Activos financieros > Roboadvisor","30/08/2024","17:44","","-1,03","EUR","","Pablo; ","4116,91"
"","","Roboadvisor","","Roboadvisor","","Inversiones Ingresos > Roboadvisor","26/08/2024","6:34","","45,00","EUR","","Pablo; ","4117,94"
"","","Roboadvisor","","Roboadvisor","","Pasivos > Activos financieros > Roboadvisor","25/08/2024","10:47","","9,29","EUR","","Pablo; ","4072,94"
"","","Roboadvisor","","Roboadvisor","","Inversiones Ingresos > Roboadvisor","19/08/2024","9:03","","45,00","EUR","","Pablo; ","4063,65"
"","","Roboadvisor","","Roboadvisor","","Pasivos > Activos financieros > Roboadvisor","18/08/2024","9:55","","32,37","EUR","","Pablo; ","4018,65"
"","","Roboadvisor","","Roboadvisor","","Inversiones Ingresos > Roboadvisor","12/08/2024","8:32","","45,00","EUR","","Pablo; ","3986,28"
"","","Roboadvisor","","Roboadvisor","","Pasivos > Activos financieros > Roboadvisor","11/08/2024","21:40","","-29,91","EUR","","Pablo; ","3941,28"
"","","Roboadvisor","","Roboadvisor","","Inversiones Ingresos > Roboadvisor","05/08/2024","9:29","","45,00","EUR","","Pablo; ","3971,19"
"","","Roboadvisor","","Roboadvisor","","Pasivos > Activos financieros > Roboadvisor","04/08/2024","10:35","","8,87","EUR","","Pablo; ","3926,19"
"","","Roboadvisor","","Roboadvisor","","Pasivos > Activos financieros > Roboadvisor","31/07/2024","23:45","","48,04","EUR","","Pablo; ","3917,32"
"","","Roboadvisor","","Roboadvisor","","Inversiones Ingresos > Roboadvisor","29/07/2024","8:49","","45,00","EUR","","Pablo; ","3869,28"
"","","Roboadvisor","","Roboadvisor","","Pasivos > Activos financieros > Roboadvisor","27/07/2024","18:34","","-25,70","EUR","","Pablo; ","3824,28"
"","","Roboadvisor","","Roboadvisor","","Inversiones Ingresos > Roboadvisor","22/07/2024","20:30","","45,00","EUR","","Pablo; ","3849,98"
"","","Roboadvisor","","Roboadvisor","","Pasivos > Activos financieros > Roboadvisor","21/07/2024","14:06","","4,16","EUR","","Pablo; ","3804,98"
"","","Roboadvisor","","Roboadvisor","","Inversiones Ingresos > Roboadvisor","15/07/2024","22:19","","45,00","EUR","","Pablo; ","3800,82"
"","","Roboadvisor","","Roboadvisor","","Pasivos > Activos financieros > Roboadvisor","14/07/2024","17:47","","14,27","EUR","","Pablo; ","3755,82"
"","","Roboadvisor","","Roboadvisor","","Pasivos > Activos financieros > Roboadvisor","09/07/2024","23:00","","18,53","EUR","","Pablo; ","3741,55"
"","","Roboadvisor","","Roboadvisor","","Inversiones Ingresos > Roboadvisor","08/07/2024","22:59","","45,00","EUR","","Pablo; ","3723,02"
"","","Roboadvisor","","Roboadvisor","","Inversiones Ingresos > Roboadvisor","01/07/2024","17:03","","45,00","EUR","","Pablo; ","3678,02"
"","","Roboadvisor","","Roboadvisor","","Pasivos > Activos financieros > Roboadvisor","30/06/2024","12:05","","-15,19","EUR","","Pablo; ","3633,02"
"","","Roboadvisor","","Roboadvisor","","Pasivos > Activos financieros > Roboadvisor","27/06/2024","7:47","","15,18","EUR","","Pablo; ","3648,21"
"","","Roboadvisor","","Roboadvisor","","Inversiones Ingresos > Roboadvisor","24/06/2024","7:45","","45,00","EUR","","Pablo; ","3633,03"
"","","Roboadvisor","","Roboadvisor","","Inversiones Ingresos > Roboadvisor","18/06/2024","7:44","","45,00","EUR","","Pablo; ","3588,03"
"","","Roboadvisor","","Roboadvisor","","Pasivos > Activos financieros > Roboadvisor","16/06/2024","13:59","","3,31","EUR","","Pablo; ","3543,03"
"","","Roboadvisor","","Roboadvisor","","Inversiones Ingresos > Roboadvisor","10/06/2024","9:35","","45,00","EUR","","Pablo; ","3539,72"
"","","Roboadvisor","","Roboadvisor","","Pasivos > Activos financieros > Roboadvisor","09/06/2024","9:34","","43,69","EUR","","Pablo; ","3494,72"
"","","Roboadvisor","","Roboadvisor","","Inversiones Ingresos > Roboadvisor","03/06/2024","8:46","","45,00","EUR","","Pablo; ","3451,03"
"","","Roboadvisor","","Roboadvisor","","Pasivos > Activos financieros > Roboadvisor","02/06/2024","7:59","","0,25","EUR","","Pablo; ","3406,03"
"","","Roboadvisor","","Roboadvisor","","Pasivos > Activos financieros > Roboadvisor","31/05/2024","19:42","","-18,71","EUR","","Pablo; ","3405,78"
"","","Roboadvisor","","Roboadvisor","","Inversiones Ingresos > Roboadvisor","27/05/2024","23:23","","45,00","EUR","","Pablo; ","3424,49"
"","","Roboadvisor","","Roboadvisor","","Pasivos > Activos financieros > Roboadvisor","25/05/2024","22:34","","-26,17","EUR","","Pablo; ","3379,49"
"","","Roboadvisor","","Roboadvisor","","Inversiones Ingresos > Roboadvisor","20/05/2024","8:04","","45,00","EUR","","Pablo; ","3405,66"
"","","Roboadvisor","","Roboadvisor","","Pasivos > Activos financieros > Roboadvisor","18/05/2024","18:53","","44,62","EUR","","Pablo; ","3360,66"
"","","Roboadvisor","","Roboadvisor","","Inversiones Ingresos > Roboadvisor","13/05/2024","21:16","","45,00","EUR","","Pablo; ","3316,04"
"","","Roboadvisor","","Roboadvisor","","Pasivos > Activos financieros > Roboadvisor","11/05/2024","7:17","","31,17","EUR","","Pablo; ","3271,04"
"","","Roboadvisor","","Roboadvisor","","Inversiones Ingresos > Roboadvisor","06/05/2024","10:44","","45,00","EUR","","Pablo; ","3239,87"
"","","Roboadvisor","","Roboadvisor","","Pasivos > Activos financieros > Roboadvisor","04/05/2024","20:32","","-12,17","EUR","","Pablo; ","3194,87"
"","","Roboadvisor","","Roboadvisor","","Pasivos > Activos financieros > Roboadvisor","30/04/2024","22:53","","25,12","EUR","","Pablo; ","3207,04"
"","","Roboadvisor","","Roboadvisor","","Inversiones Ingresos > Roboadvisor","29/04/2024","7:51","","45,00","EUR","","Pablo; ","3181,92"
"","","Roboadvisor","","Roboadvisor","","Pasivos > Activos financieros > Roboadvisor","27/04/2024","14:00","","9,82","EUR","","Pablo; ","3136,92"
"","","Roboadvisor","","Roboadvisor","","Inversiones Ingresos > Roboadvisor","22/04/2024","7:46","","45,00","EUR","","Pablo; ","3127,10"
"","","Roboadvisor","","Roboadvisor","","Pasivos > Activos financieros > Roboadvisor","20/04/2024","12:27","","-87,33","EUR","","Pablo; ","3082,10"
"","","Roboadvisor","","Roboadvisor","","Inversiones Ingresos > Roboadvisor","15/04/2024","8:57","","45,00","EUR","","Pablo; ","3169,43"
"","","Roboadvisor","","Roboadvisor","","Pasivos > Activos financieros > Roboadvisor","13/04/2024","9:48","","51,28","EUR","","Pablo; ","3124,43"
"","","Roboadvisor","","Roboadvisor","","Inversiones Ingresos > Roboadvisor","08/04/2024","8:41","","45,00","EUR","","Pablo; ","3073,15"
"","","Roboadvisor","","Roboadvisor","","Pasivos > Activos financieros > Roboadvisor","07/04/2024","6:43","","-52,76","EUR","","Pablo; ","3028,15"
"","","Roboadvisor","","Roboadvisor","","Inversiones Ingresos > Roboadvisor","01/04/2024","13:32","","45,00","EUR","","Pablo; ","3080,91"
"","","Roboadvisor","","Roboadvisor","","Pasivos > Activos financieros > Roboadvisor","29/03/2024","22:57","","13,80","EUR","","Pablo; ","3035,91"
"","","Roboadvisor","","Roboadvisor","","Inversiones Ingresos > Roboadvisor","25/03/2024","10:12","","45,00","EUR","","Pablo; ","3022,11"
"","","Roboadvisor","","Roboadvisor","","Pasivos > Activos financieros > Roboadvisor","23/03/2024","20:46","","5,53","EUR","","Pablo; ","2977,11"
"","","Roboadvisor","","Roboadvisor","","Pasivos > Activos financieros > Roboadvisor","22/03/2024","21:41","","40,72","EUR","","Pablo; ","2971,58"
"","","Roboadvisor","","Roboadvisor","","Inversiones Ingresos > Roboadvisor","18/03/2024","12:14","","45,00","EUR","","Pablo; ","2930,86"
"","","Roboadvisor","","Roboadvisor","","Pasivos > Activos financieros > Roboadvisor","17/03/2024","14:11","","11,12","EUR","","Pablo; ","2885,86"
"","","Roboadvisor","","Roboadvisor","","Inversiones Ingresos > Roboadvisor","11/03/2024","7:12","","45,00","EUR","","Pablo; ","2874,74"
"","","Roboadvisor","","Roboadvisor","","Pasivos > Activos financieros > Roboadvisor","10/03/2024","14:35","","14,29","EUR","","Pablo; ","2829,74"
"","","Roboadvisor","","Roboadvisor","","Pasivos > Activos financieros > Roboadvisor","08/03/2024","17:46","","1,16","EUR","","Pablo; ","2815,45"
"","","Roboadvisor","","Roboadvisor","","Inversiones Ingresos > Roboadvisor","04/03/2024","17:56","","45,00","EUR","","Pablo; ","2814,29"
"","","Roboadvisor","","Roboadvisor","","Pasivos > Activos financieros > Roboadvisor","03/03/2024","8:50","","11,44","EUR","","Pablo; ","2769,29"
"","","Roboadvisor","","Roboadvisor","","Pasivos > Activos financieros > Roboadvisor","29/02/2024","23:42","","-14,97","EUR","","Pablo; ","2757,85"
"","","Roboadvisor","","Roboadvisor","","Inversiones Ingresos > Roboadvisor","26/02/2024","23:38","","45,00","EUR","","Pablo; ","2772,82"
"","","Roboadvisor","","Roboadvisor","","Pasivos > Activos financieros > Roboadvisor","24/02/2024","5:52","","26,21","EUR","","Pablo; ","2727,82"
"","","Roboadvisor","","Roboadvisor","","Inversiones Ingresos > Roboadvisor","19/02/2024","6:20","","45,00","EUR","","Pablo; ","2701,61"
"","","Roboadvisor","","Roboadvisor","","Pasivos > Activos financieros > Roboadvisor","18/02/2024","16:36","","1,37","EUR","","Pablo; ","2656,61"
"","","Roboadvisor","","Roboadvisor","","Pasivos > Activos financieros > Roboadvisor","16/02/2024","21:21","","16,70","EUR","","Pablo; ","2655,24"
"","","Roboadvisor","","Roboadvisor","","Inversiones Ingresos > Roboadvisor","12/02/2024","18:43","","45,00","EUR","","Pablo; ","2638,54"
"","","Roboadvisor","","Roboadvisor","","Pasivos > Activos financieros > Roboadvisor","10/02/2024","7:35","","39,60","EUR","","Pablo; ","2593,54"
"","","Roboadvisor","","Roboadvisor","","Pasivos > Activos financieros > Roboadvisor","05/02/2024","7:18","","19,41","EUR","","Pablo; ","2553,94"
"","","Roboadvisor","","Roboadvisor","","Inversiones Ingresos > Roboadvisor","05/02/2024","7:17","","45,00","EUR","","Pablo; ","2534,53"
"","","Roboadvisor","","Roboadvisor","","Pasivos > Activos financieros > Roboadvisor","31/01/2024","19:03","","-12,56","EUR","","Pablo; ","2489,53"
"","","Roboadvisor","","Roboadvisor","","Inversiones Ingresos > Roboadvisor","29/01/2024","19:02","","45,00","EUR","","Pablo; ","2502,09"
"","","Roboadvisor","","Roboadvisor","","Pasivos > Activos financieros > Roboadvisor","28/01/2024","0:37","","57,45","EUR","","Pablo; ","2457,09"
"","","Roboadvisor","","Roboadvisor","","Inversiones Ingresos > Roboadvisor","22/01/2024","23:53","","45,00","EUR","","Pablo; ","2399,64"
"","","Roboadvisor","","Roboadvisor","","Pasivos > Activos financieros > Roboadvisor","20/01/2024","18:06","","0,84","EUR","","Pablo; ","2354,64"
"","","Roboadvisor","","Roboadvisor","","Inversiones Ingresos > Roboadvisor","15/01/2024","23:23","","45,00","EUR","","Pablo; ","2353,80"
"","","Roboadvisor","","Roboadvisor","","Pasivos > Activos financieros > Roboadvisor","14/01/2024","19:08","","30,77","EUR","","Pablo; ","2308,80"
"","","Roboadvisor","","Roboadvisor","","Inversiones Ingresos > Roboadvisor","08/01/2024","18:21","","45,00","EUR","","Pablo; ","2278,03"
"","","Roboadvisor","","Roboadvisor","","Pasivos > Activos financieros > Roboadvisor","07/01/2024","10:34","","-17,17","EUR","","Pablo; ","2233,03"
"","","Roboadvisor","","Roboadvisor","","Inversiones Ingresos > Roboadvisor","04/01/2024","19:34","","45,00","EUR","","Pablo; ","2250,20"
"","","Roboadvisor","","Roboadvisor","","Pasivos > Activos financieros > Roboadvisor","31/12/2023","10:19","","6,84","EUR","","Pablo; ","2205,20"
"","","Roboadvisor","","Roboadvisor","","Pasivos > Activos financieros > Roboadvisor","25/12/2023","21:25","","0,94","EUR","","Pablo; ","2198,36"
"","","Roboadvisor","","Roboadvisor","","Inversiones Ingresos > Roboadvisor","25/12/2023","21:24","","45,00","EUR","","Pablo; ","2197,42"
"","","Roboadvisor","","Roboadvisor","","Pasivos > Activos financieros > Roboadvisor","23/12/2023","19:45","","-12,41","EUR","","Pablo; ","2152,42"
"","","Roboadvisor","","Roboadvisor","","Inversiones Ingresos > Roboadvisor","18/12/2023","21:33","","45,00","EUR","","Pablo; ","2164,83"
"","","Roboadvisor","","Roboadvisor","","Pasivos > Activos financieros > Roboadvisor","17/12/2023","16:32","","25,40","EUR","","Pablo; ","2119,83"
"","","Roboadvisor","","Roboadvisor","","Inversiones Ingresos > Roboadvisor","11/12/2023","8:31","","45,00","EUR","","Pablo; ","2094,43"
"","","Roboadvisor","","Roboadvisor","","Pasivos > Activos financieros > Roboadvisor","10/12/2023","17:25","","-0,23","EUR","","Pablo; ","2049,43"
"","","Roboadvisor","","Roboadvisor","","Pasivos > Activos financieros > Roboadvisor","08/12/2023","23:37","","36,33","EUR","","Pablo; ","2049,66"
"","","Roboadvisor","","Roboadvisor","","Inversiones Ingresos > Roboadvisor","04/12/2023","12:25","","45,00","EUR","","Pablo; ","2013,33"
"","","Roboadvisor","","Roboadvisor","","Pasivos > Activos financieros > Roboadvisor","03/12/2023","11:02","","3,03","EUR","","Pablo; ","1968,33"
"","","Roboadvisor","","Roboadvisor","","Pasivos > Activos financieros > Roboadvisor","30/11/2023","9:45","","4,12","EUR","","Pablo; ","1965,30"
"","","Roboadvisor","","Roboadvisor","","Inversiones Ingresos > Roboadvisor","27/11/2023","18:16","","45,00","EUR","","Pablo; ","1961,18"
"","","Roboadvisor","","Roboadvisor","","Pasivos > Activos financieros > Roboadvisor","24/11/2023","21:40","","11,22","EUR","","Pablo; ","1916,18"
"","","Roboadvisor","","Roboadvisor","","Inversiones Ingresos > Roboadvisor","20/11/2023","21:08","","45,00","EUR","","Pablo; ","1904,96"
"","","Roboadvisor","","Roboadvisor","","Pasivos > Activos financieros > Roboadvisor","18/11/2023","10:03","","25,70","EUR","","Pablo; ","1859,96"
"","","Roboadvisor","","Roboadvisor","","Inversiones Ingresos > Roboadvisor","13/11/2023","8:38","","45,00","EUR","","Pablo; ","1834,26"
"","","Roboadvisor","","Roboadvisor","","Pasivos > Activos financieros > Roboadvisor","12/11/2023","8:29","","7,30","EUR","","Pablo; ","1789,26"
"","","Roboadvisor","","Roboadvisor","","Inversiones Ingresos > Roboadvisor","06/11/2023","15:08","","45,00","EUR","","Pablo; ","1781,96"
"","","Roboadvisor","","Roboadvisor","","Pasivos > Activos financieros > Roboadvisor","05/11/2023","13:01","","36,62","EUR","","Pablo; ","1736,96"
"","","Roboadvisor","","Roboadvisor","","Pasivos > Activos financieros > Roboadvisor","31/10/2023","20:01","","0,92","EUR","","Pablo; ","1700,34"
"","","Roboadvisor","","Fondos","","Inversiones Ingresos > Roboadvisor","30/10/2023","17:32","","50,00","EUR","","Pablo; ","1699,42"
"","","Roboadvisor","","Roboadvisor","","Pasivos > Activos financieros > Roboadvisor","28/10/2023","12:00","","-22,65","EUR","","Pablo; ","1649,42"
"","","Roboadvisor","","Roboadvisor","","Pasivos > Activos financieros > Roboadvisor","22/10/2023","9:39","","-31,95","EUR","","Pablo; ","1672,07"
"","","Roboadvisor","","Fondos","","Inversiones Ingresos > Roboadvisor","16/10/2023","21:18","","50,00","EUR","","Pablo; ","1704,02"
"","","Roboadvisor","","Roboadvisor","","Pasivos > Activos financieros > Roboadvisor","14/10/2023","20:01","","25,82","EUR","","Pablo; ","1654,02"
"","","Roboadvisor","","Roboadvisor","","Pasivos > Activos financieros > Roboadvisor","07/10/2023","19:11","","-14,99","EUR","","Pablo; ","1628,20"
"","","Roboadvisor","","Fondos","","Inversiones Ingresos > Roboadvisor","02/10/2023","7:21","","50,00","EUR","","Pablo; ","1643,19"
"","","Roboadvisor","","Roboadvisor","","Pasivos > Activos financieros > Roboadvisor","30/09/2023","7:20","","-3,35","EUR","","Pablo; ","1593,19"
"","","Roboadvisor","","Roboadvisor","","Pasivos > Activos financieros > Roboadvisor","24/09/2023","10:58","","-48,09","EUR","","Pablo; ","1596,54"
"","","Roboadvisor","","Fondos","","Inversiones Ingresos > Roboadvisor","20/09/2023","9:01","","50,00","EUR","","Pablo; ","1644,63"
"","","Roboadvisor","","Roboadvisor","","Pasivos > Activos financieros > Roboadvisor","16/09/2023","7:00","","23,28","EUR","","Pablo; ","1594,63"
"","","Roboadvisor","","Roboadvisor","","Pasivos > Activos financieros > Roboadvisor","09/09/2023","13:00","","0,62","EUR","","Pablo; ","1571,35"
"","","Roboadvisor","","Fondos","","Inversiones Ingresos > Roboadvisor","04/09/2023","16:31","","50,00","EUR","","Pablo; ","1570,73"
"","","Roboadvisor","","Roboadvisor","","Pasivos > Activos financieros > Roboadvisor","03/09/2023","22:22","","-0,18","EUR","","Pablo; ","1520,73"
"","","Roboadvisor","","Roboadvisor","","Pasivos > Activos financieros > Roboadvisor","01/09/2023","23:29","","4,62","EUR","","Pablo; ","1520,91"
"","","Roboadvisor","","Roboadvisor","","Pasivos > Activos financieros > Roboadvisor","31/08/2023","12:19","","25,76","EUR","","Pablo; ","1516,29"
"","","Roboadvisor","","Roboadvisor","","Pasivos > Activos financieros > Roboadvisor","26/08/2023","15:59","","11,41","EUR","","Pablo; ","1490,53"
"","","Roboadvisor","","Fondos","","Inversiones Ingresos > Roboadvisor","23/08/2023","9:41","","50,00","EUR","","Pablo; ","1479,12"
"","","Roboadvisor","","Roboadvisor","","Pasivos > Activos financieros > Roboadvisor","21/08/2023","20:41","","-24,22","EUR","","Pablo; ","1429,12"
"","","Roboadvisor","","Roboadvisor","","Pasivos > Activos financieros > Roboadvisor","14/08/2023","15:47","","-13,19","EUR","","Pablo; ","1453,34"
"","","Roboadvisor","","Fondos","","Inversiones Ingresos > Roboadvisor","08/08/2023","10:00","","50,00","EUR","","Pablo; ","1466,53"
"","","Roboadvisor","","Roboadvisor","","Pasivos > Activos financieros > Roboadvisor","06/08/2023","11:24","","-19,41","EUR","","Pablo; ","1416,53"
"","","Roboadvisor","","Roboadvisor","","Pasivos > Activos financieros > Roboadvisor","31/07/2023","20:13","","3,90","EUR","","Pablo; ","1435,94"
"","","Roboadvisor","","Roboadvisor","","Pasivos > Activos financieros > Roboadvisor","31/07/2023","6:51","","0,07","EUR","","Pablo; ","1432,04"
"","","Roboadvisor","","Roboadvisor","","Pasivos > Activos financieros > Roboadvisor","29/07/2023","11:41","","21,05","EUR","","Pablo; ","1431,97"
"","","Roboadvisor","","Fondos","","Inversiones Ingresos > Roboadvisor","25/07/2023","17:21","","50,00","EUR","","Pablo; ","1410,92"
"","","Roboadvisor","","Roboadvisor","","Pasivos > Activos financieros > Roboadvisor","23/07/2023","6:03","","8,16","EUR","","Pablo; ","1360,92"
"","","Roboadvisor","","Roboadvisor","","Pasivos > Activos financieros > Roboadvisor","16/07/2023","11:12","","2,74","EUR","","Pablo; ","1352,76"
"","","Roboadvisor","","Fondos","","Inversiones Ingresos > Roboadvisor","11/07/2023","6:34","","50,00","EUR","","Pablo; ","1350,02"
"","","Roboadvisor","","Roboadvisor","","Pasivos > Activos financieros > Roboadvisor","09/07/2023","18:58","","-14,78","EUR","","Pablo; ","1300,02"
"","","Roboadvisor","","Roboadvisor","","Pasivos > Activos financieros > Roboadvisor","02/07/2023","20:54","","-0,42","EUR","","Pablo; ","1314,80"
"","","Roboadvisor","","Roboadvisor","","Pasivos > Activos financieros > Roboadvisor","30/06/2023","7:59","","7,13","EUR","","Pablo; ","1315,22"
"","","Roboadvisor","","Fondos","","Inversiones Ingresos > Roboadvisor","27/06/2023","20:09","","50,00","EUR","","Pablo; ","1308,09"
"","","Roboadvisor","","Roboadvisor","","Pasivos > Activos financieros > Roboadvisor","25/06/2023","9:04","","-0,88","EUR","","Pablo; ","1258,09"
"","","Roboadvisor","","Roboadvisor","","Pasivos > Activos financieros > Roboadvisor","18/06/2023","9:24","","3,14","EUR","","Pablo; ","1258,97"
"","","Roboadvisor","","Fondos","","Inversiones Ingresos > Roboadvisor","14/06/2023","11:32","","50,00","EUR","","Pablo; ","1255,83"
"","","Roboadvisor","","Roboadvisor","","Pasivos > Activos financieros > Roboadvisor","11/06/2023","22:40","","-5,91","EUR","","Pablo; ","1205,83"
"","","Roboadvisor","","Roboadvisor","","Pasivos > Activos financieros > Roboadvisor","04/06/2023","18:17","","0,79","EUR","","Pablo; ","1211,74"
"","","Roboadvisor","","Roboadvisor","","Pasivos > Activos financieros > Roboadvisor","31/05/2023","18:51","","14,56","EUR","","Pablo; ","1210,95"
"","","Roboadvisor","","Fondos","","Inversiones Ingresos > Roboadvisor","30/05/2023","18:49","","50,00","EUR","","Pablo; ","1196,39"
"","","Roboadvisor","","Roboadvisor","","Pasivos > Activos financieros > Roboadvisor","28/05/2023","17:25","","-4,16","EUR","","Pablo; ","1146,39"
"","","Roboadvisor","","Roboadvisor","","Pasivos > Activos financieros > Roboadvisor","21/05/2023","13:26","","-13,88","EUR","","Pablo; ","1150,55"
"","","Roboadvisor","","Fondos","","Inversiones Ingresos > Roboadvisor","17/05/2023","20:07","","50,00","EUR","","Pablo; ","1164,43"
"","","Roboadvisor","","Roboadvisor","","Pasivos > Activos financieros > Roboadvisor","14/05/2023","21:55","","2,07","EUR","","Pablo; ","1114,43"
"","","Roboadvisor","","Roboadvisor","","Pasivos > Activos financieros > Roboadvisor","07/05/2023","11:29","","7,99","EUR","","Pablo; ","1112,36"
"","","Roboadvisor","","Fondos","","Inversiones Ingresos > Roboadvisor","01/05/2023","14:00","","50,00","EUR","","Pablo; ","1104,37"
"","","Roboadvisor","","Roboadvisor","","Pasivos > Activos financieros > Roboadvisor","30/04/2023","14:54","","-1,61","EUR","","Pablo; ","1054,37"
"","","Roboadvisor","","Roboadvisor","","Pasivos > Activos financieros > Roboadvisor","23/04/2023","19:41","","-3,45","EUR","","Pablo; ","1055,98"
"","","Roboadvisor","","Fondos","","Inversiones Ingresos > Roboadvisor","17/04/2023","22:14","","50,00","EUR","","Pablo; ","1059,43"
"","","Roboadvisor","","Roboadvisor","","Pasivos > Activos financieros > Roboadvisor","16/04/2023","17:16","","-8,13","EUR","","Pablo; ","1009,43"
"","","Roboadvisor","","Roboadvisor","","Pasivos > Activos financieros > Roboadvisor","09/04/2023","13:40","","6,93","EUR","","Pablo; ","1017,56"
"","","Roboadvisor","","Roboadvisor","","Pasivos > Activos financieros > Roboadvisor","04/04/2023","9:06","","6,29","EUR","","Pablo; ","1010,63"
"","","Roboadvisor","","Fondos","","Inversiones Ingresos > Roboadvisor","03/04/2023","17:58","","50,00","EUR","","Pablo; ","1004,34"
"","","Roboadvisor","","Roboadvisor","","Pasivos > Activos financieros > Roboadvisor","31/03/2023","20:18","","-6,68","EUR","","Pablo; ","954,34"
"","","Roboadvisor","","Roboadvisor","","Pasivos > Activos financieros > Roboadvisor","26/03/2023","19:47","","6,97","EUR","","Pablo; ","961,02"
"","","Roboadvisor","","Fondos","","Inversiones Ingresos > Roboadvisor","20/03/2023","19:51","","50,00","EUR","","Pablo; ","954,05"
"","","Roboadvisor","","Roboadvisor","","Pasivos > Activos financieros > Roboadvisor","19/03/2023","12:00","","12,38","EUR","","Pablo; ","904,05"
"","","Roboadvisor","","Roboadvisor","","Pasivos > Activos financieros > Roboadvisor","12/03/2023","18:08","","-7,01","EUR","","Pablo; ","891,67"
"","","Roboadvisor","","Fondos","","Inversiones Ingresos > Roboadvisor","06/03/2023","21:38","","50,00","EUR","","Pablo; ","898,68"
"","","Roboadvisor","","Roboadvisor","","Pasivos > Activos financieros > Roboadvisor","05/03/2023","18:35","","-0,33","EUR","","Pablo; ","848,68"
"","","Roboadvisor","","Roboadvisor","","Pasivos > Activos financieros > Roboadvisor","28/02/2023","21:44","","-5,39","EUR","","Pablo; ","849,01"
"","","Roboadvisor","","Fondos","","Inversiones Ingresos > Roboadvisor","27/02/2023","20:03","","50,00","EUR","","Pablo; ","854,40"
"","","Roboadvisor","","Roboadvisor","","Pasivos > Activos financieros > Roboadvisor","26/02/2023","9:35","","-8,88","EUR","","Pablo; ","804,40"
"","","Roboadvisor","","Fondos","","Inversiones Ingresos > Roboadvisor","20/02/2023","14:37","","50,00","EUR","","Pablo; ","813,28"
"","","Roboadvisor","","Roboadvisor","","Pasivos > Activos financieros > Roboadvisor","19/02/2023","9:43","","2,92","EUR","","Pablo; ","763,28"
"","","Roboadvisor","","Fondos","","Inversiones Ingresos > Roboadvisor","13/02/2023","20:04","","50,00","EUR","","Pablo; ","760,36"
"","","Roboadvisor","","Roboadvisor","","Pasivos > Activos financieros > Roboadvisor","12/02/2023","12:04","","-2,70","EUR","","Pablo; ","710,36"
"","","Roboadvisor","","Fondos","","Inversiones Ingresos > Roboadvisor","06/02/2023","21:41","","50,00","EUR","","Pablo; ","713,06"
"","","Roboadvisor","","Roboadvisor","","Pasivos > Activos financieros > Roboadvisor","05/02/2023","14:52","","8,30","EUR","","Pablo; ","663,06"
"","","Roboadvisor","","Fondos","","Inversiones Ingresos > Roboadvisor","30/01/2023","19:00","","50,00","EUR","","Pablo; ","654,76"
"","","Roboadvisor","","Roboadvisor","","Pasivos > Activos financieros > Roboadvisor","29/01/2023","10:25","","0,37","EUR","","Pablo; ","604,76"
"","","Roboadvisor","","Fondos","","Inversiones Ingresos > Roboadvisor","23/01/2023","16:21","","50,00","EUR","","Pablo; ","604,39"
"","","Roboadvisor","","Roboadvisor","","Pasivos > Activos financieros > Roboadvisor","22/01/2023","14:12","","-0,60","EUR","","Pablo; ","554,39"
"","","Roboadvisor","","Fondos","","Inversiones Ingresos > Roboadvisor","16/01/2023","22:01","","50,00","EUR","","Pablo; ","554,99"
"","","Roboadvisor","","Roboadvisor","","Pasivos > Activos financieros > Roboadvisor","15/01/2023","16:14","","11,37","EUR","","Pablo; ","504,99"
"","","Roboadvisor","","Fondos","","Inversiones Ingresos > Roboadvisor","15/01/2023","11:55","","50,00","EUR","","Pablo; ","493,62"
"","","Roboadvisor","","Fondos","","Inversiones Ingresos > Roboadvisor","12/01/2023","23:15","","50,00","EUR","","Pablo; ","443,62"
"","","Roboadvisor","","Fondos","","Pasivos > Activos financieros > Roboadvisor","31/12/2022","19:07","","-10,87","EUR","","","393,62"
"","","Roboadvisor","","Fondos","","Pasivos > Activos financieros > Roboadvisor","30/11/2022","19:07","","0,97","EUR","","","404,49"
"","","Roboadvisor","","Fondos","","Inversiones Ingresos > Roboadvisor","03/11/2022","18:45","","403,52","EUR","","Pablo; ","403,52"
"MSCI World","201,23","EUR","","","","","","","","","","","",""
"","","MSCI World","","Fondos","","Pasivos > Activos financieros > Fondos","11/05/2025","11:38","","3,37","EUR","","Pablo; ","201,23"
"","","MSCI World","","Fondos","","Inversiones Ingresos > Fondos","09/05/2025","18:45","","15,00","EUR","","Pablo; ","197,86"
"","","MSCI World","","Cashback","","Pasivos > Activos financieros > Cashback","02/05/2025","19:51","","4,72","EUR","","Pablo; ","182,86"
"","","MSCI World","","Fondos","","Inversiones Ingresos > Fondos","02/05/2025","19:51","","15,00","EUR","","Pablo; ","178,14"
"","","MSCI World","","Fondos","","Pasivos > Activos financieros > Fondos","30/04/2025","23:48","","8,16","EUR","","Pablo; ","163,14"
"","","MSCI World","","Fondos","","Inversiones Ingresos > Fondos","23/04/2025","16:17","","15,00","EUR","","Pablo; ","154,98"
"","","MSCI World","","Fondos","","Inversiones Ingresos > Fondos","16/04/2025","9:20","","15,00","EUR","","Pablo; ","139,98"
"","","MSCI World","","Fondos","","Pasivos > Activos financieros > Fondos","13/04/2025","22:37","","-9,18","EUR","","Pablo; ","124,98"
"","","MSCI World","","Fondos","","Inversiones Ingresos > Fondos","09/04/2025","22:20","","15,00","EUR","","Pablo; ","134,16"
"","","MSCI World","","Cashback","","Pasivos > Activos financieros > Cashback","02/04/2025","18:21","","11,98","EUR","","Pablo; ","119,16"
"","","MSCI World","","Fondos","","Inversiones Ingresos > Fondos","02/04/2025","18:21","","15,00","EUR","","Pablo; ","107,18"
"","","MSCI World","","Fondos","","Pasivos > Activos financieros > Fondos","30/03/2025","13:58","","-2,38","EUR","","Pablo; ","92,18"
"","","MSCI World","","Fondos","","Inversiones Ingresos > Fondos","24/03/2025","19:55","","15,00","EUR","","Pablo; ","94,56"
"","","MSCI World","","Fondos","","Pasivos > Activos financieros > Fondos","23/03/2025","8:15","","1,12","EUR","","Pablo; ","79,56"
"","","MSCI World","","Fondos","","Inversiones Ingresos > Fondos","17/03/2025","19:15","","15,00","EUR","","Pablo; ","78,44"
"","","MSCI World","","Fondos","","Pasivos > Activos financieros > Fondos","15/03/2025","22:58","","-1,25","EUR","","Pablo; ","63,44"
"","","MSCI World","","Fondos","","Inversiones Ingresos > Fondos","10/03/2025","22:53","","15,00","EUR","","Pablo; ","64,69"
"","","MSCI World","","Fondos","","Pasivos > Activos financieros > Fondos","08/03/2025","21:18","","-2,51","EUR","","Pablo; ","49,69"
"","","MSCI World","","Cashback","","Pasivos > Activos financieros > Cashback","03/03/2025","21:16","","7,86","EUR","","Pablo; ","52,20"
"","","MSCI World","","Fondos","","Inversiones Ingresos > Fondos","03/03/2025","17:50","","15,00","EUR","","Pablo; ","44,34"
"","","MSCI World","","Fondos","","Pasivos > Activos financieros > Fondos","28/02/2025","8:17","","-0,66","EUR","","Pablo; ","29,34"
"","","MSCI World","","Fondos","","Inversiones Ingresos > Fondos","24/02/2025","8:14","","15,00","EUR","","Pablo; ","30,00"
"","","MSCI World","","Fondos","","Inversiones Ingresos > Fondos","18/02/2025","10:16","","15,00","EUR","","Pablo; ","15,00"
"Plan De Pensiones","4695,03","EUR","","","","","","","","","","","",""
"","","Plan De Pensiones","","Plan De Pensiones","","Pasivos > Activos financieros > Plan De Pensiones","11/05/2025","11:39","","89,63","EUR","","Pablo; ","4695,03"
"","","Plan De Pensiones","","Plan Pensiones","","Inversiones Ingresos > Plan De Pensiones","07/05/2025","10:19","","30,00","EUR","","Pablo; ","4605,40"
"","","Plan De Pensiones","","Plan De Pensiones","","Pasivos > Activos financieros > Plan De Pensiones","30/04/2025","22:58","","154,66","EUR","","Pablo; ","4575,40"
"","","Plan De Pensiones","","Plan Pensiones","","Inversiones Ingresos > Plan De Pensiones","29/04/2025","16:59","","30,00","EUR","","Pablo; ","4420,74"
"","","Plan De Pensiones","","Plan Pensiones","","Inversiones Ingresos > Plan De Pensiones","24/04/2025","19:28","","30,00","EUR","","Pablo; ","4390,74"
"","","Plan De Pensiones","","Plan Pensiones","","Inversiones Ingresos > Plan De Pensiones","17/04/2025","8:55","","30,00","EUR","","Pablo; ","4360,74"
"","","Plan De Pensiones","","Plan De Pensiones","","Pasivos > Activos financieros > Plan De Pensiones","13/04/2025","22:37","","-542,39","EUR","","Pablo; ","4330,74"
"","","Plan De Pensiones","","Plan Pensiones","","Inversiones Ingresos > Plan De Pensiones","09/04/2025","20:19","","30,00","EUR","","Pablo; ","4873,13"
"","","Plan De Pensiones","","Plan Pensiones","","Inversiones Ingresos > Plan De Pensiones","01/04/2025","18:56","","30,00","EUR","","Pablo; ","4843,13"
"","","Plan De Pensiones","","Plan De Pensiones","","Pasivos > Activos financieros > Plan De Pensiones","30/03/2025","13:43","","53,59","EUR","","Pablo; ","4813,13"
"","","Plan De Pensiones","","Plan Pensiones","","Inversiones Ingresos > Plan De Pensiones","26/03/2025","13:41","","30,00","EUR","","Pablo; ","4759,54"
"","","Plan De Pensiones","","Plan De Pensiones","","Pasivos > Activos financieros > Plan De Pensiones","23/03/2025","8:15","","116,01","EUR","","Pablo; ","4729,54"
"","","Plan De Pensiones","","Plan Pensiones","","Inversiones Ingresos > Plan De Pensiones","19/03/2025","10:32","","30,00","EUR","","Pablo; ","4613,53"
"","","Plan De Pensiones","","Plan De Pensiones","","Pasivos > Activos financieros > Plan De Pensiones","15/03/2025","22:51","","-228,92","EUR","","Pablo; ","4583,53"
"","","Plan De Pensiones","","Plan Pensiones","","Inversiones Ingresos > Plan De Pensiones","10/03/2025","18:25","","30,00","EUR","","Pablo; ","4812,45"
"","","Plan De Pensiones","","Plan De Pensiones","","Pasivos > Activos financieros > Plan De Pensiones","08/03/2025","20:57","","-343,38","EUR","","Pablo; ","4782,45"
"","","Plan De Pensiones","","Plan Pensiones","","Inversiones Ingresos > Plan De Pensiones","04/03/2025","18:37","","30,00","EUR","","Pablo; ","5125,83"
"","","Plan De Pensiones","","Plan De Pensiones","","Pasivos > Activos financieros > Plan De Pensiones","28/02/2025","8:28","","-3,89","EUR","","Pablo; ","5095,83"
"","","Plan De Pensiones","","Plan Pensiones","","Inversiones Ingresos > Plan De Pensiones","25/02/2025","23:03","","30,00","EUR","","Pablo; ","5099,72"
"","","Plan De Pensiones","","Plan Pensiones","","Inversiones Ingresos > Plan De Pensiones","18/02/2025","13:04","","30,00","EUR","","Pablo; ","5069,72"
"","","Plan De Pensiones","","Plan De Pensiones","","Pasivos > Activos financieros > Plan De Pensiones","15/02/2025","0:37","","0,13","EUR","","Pablo; ","5039,72"
"","","Plan De Pensiones","","Plan Pensiones","","Inversiones Ingresos > Plan De Pensiones","11/02/2025","11:21","","30,00","EUR","","Pablo; ","5039,59"
"","","Plan De Pensiones","","Plan Pensiones","","Inversiones Ingresos > Plan De Pensiones","04/02/2025","16:29","","30,00","EUR","","Pablo; ","5009,59"
"","","Plan De Pensiones","","Plan De Pensiones","","Pasivos > Activos financieros > Plan De Pensiones","31/01/2025","20:48","","-0,05","EUR","","Pablo; ","4979,59"
"","","Plan De Pensiones","","Plan Pensiones","","Inversiones Ingresos > Plan De Pensiones","28/01/2025","12:47","","30,00","EUR","","Pablo; ","4979,64"
"","","Plan De Pensiones","","Plan De Pensiones","","Pasivos > Activos financieros > Plan De Pensiones","26/01/2025","21:14","","0,88","EUR","","Pablo; ","4949,64"
"","","Plan De Pensiones","","Plan De Pensiones","","Pasivos > Activos financieros > Plan De Pensiones","18/01/2025","10:22","","0,43","EUR","","Pablo; ","4948,76"
"","","Plan De Pensiones","","Plan Pensiones","","Inversiones Ingresos > Plan De Pensiones","14/01/2025","7:17","","30,00","EUR","","Pablo; ","4948,33"
"","","Plan De Pensiones","","Plan De Pensiones","","Pasivos > Activos financieros > Plan De Pensiones","12/01/2025","10:52","","-15,55","EUR","","Pablo; ","4918,33"
"","","Plan De Pensiones","","Plan Pensiones","","Inversiones Ingresos > Plan De Pensiones","07/01/2025","17:29","","30,00","EUR","","Pablo; ","4933,88"
"","","Plan De Pensiones","","Plan De Pensiones","","Pasivos > Activos financieros > Plan De Pensiones","05/01/2025","9:45","","15,51","EUR","","Pablo; ","4903,88"
"","","Plan De Pensiones","","Plan De Pensiones","","Pasivos > Activos financieros > Plan De Pensiones","28/12/2024","19:31","","1,90","EUR","","Pablo; ","4888,37"
"","","Plan De Pensiones","","Plan De Pensiones","","Pasivos > Activos financieros > Plan De Pensiones","22/12/2024","21:38","","-49,17","EUR","","Pablo; ","4886,47"
"","","Plan De Pensiones","","Plan De Pensiones","","Pasivos > Activos financieros > Plan De Pensiones","15/12/2024","16:12","","2,23","EUR","","Pablo; ","4935,64"
"","","Plan De Pensiones","","Plan De Pensiones","","Pasivos > Activos financieros > Plan De Pensiones","09/12/2024","17:54","","24,49","EUR","","Pablo; ","4933,41"
"","","Plan De Pensiones","","Plan Pensiones","","Inversiones Ingresos > Plan De Pensiones","05/12/2024","15:05","","30,00","EUR","","Pablo; ","4908,92"
"","","Plan De Pensiones","","Plan De Pensiones","","Pasivos > Activos financieros > Plan De Pensiones","02/12/2024","17:52","","36,43","EUR","","Pablo; ","4878,92"
"","","Plan De Pensiones","","Plan Pensiones","","Inversiones Ingresos > Plan De Pensiones","27/11/2024","23:31","","30,00","EUR","","Pablo; ","4842,49"
"","","Plan De Pensiones","","Plan De Pensiones","","Pasivos > Activos financieros > Plan De Pensiones","24/11/2024","19:35","","9,82","EUR","","Pablo; ","4812,49"
"","","Plan De Pensiones","","Plan Pensiones","","Inversiones Ingresos > Plan De Pensiones","19/11/2024","17:48","","30,00","EUR","","Pablo; ","4802,67"
"","","Plan De Pensiones","","Plan De Pensiones","","Pasivos > Activos financieros > Plan De Pensiones","17/11/2024","20:08","","17,39","EUR","","Pablo; ","4772,67"
"","","Plan De Pensiones","","Plan Pensiones","","Inversiones Ingresos > Plan De Pensiones","12/11/2024","19:14","","30,00","EUR","","Pablo; ","4755,28"
"","","Plan De Pensiones","","Plan Pensiones","","Inversiones Ingresos > Plan De Pensiones","10/11/2024","22:15","","60,00","EUR","","Pablo; ","4725,28"
"","","Plan De Pensiones","","Plan De Pensiones","","Pasivos > Activos financieros > Plan De Pensiones","09/11/2024","13:36","","23,03","EUR","","Pablo; ","4665,28"
"","","Plan De Pensiones","","Plan De Pensiones","","Pasivos > Activos financieros > Plan De Pensiones","01/11/2024","18:02","","-24,59","EUR","","Pablo; ","4642,25"
"","","Plan De Pensiones","","Plan De Pensiones","","Pasivos > Activos financieros > Plan De Pensiones","27/10/2024","19:22","","-15,70","EUR","","Pablo; ","4666,84"
"","","Plan De Pensiones","","Plan Pensiones","","Inversiones Ingresos > Plan De Pensiones","23/10/2024","19:21","","30,00","EUR","","Pablo; ","4682,54"
"","","Plan De Pensiones","","Plan De Pensiones","","Pasivos > Activos financieros > Plan De Pensiones","19/10/2024","15:34","","29,57","EUR","","Pablo; ","4652,54"
"","","Plan De Pensiones","","Plan Pensiones","","Inversiones Ingresos > Plan De Pensiones","16/10/2024","19:31","","30,00","EUR","","Pablo; ","4622,97"
"","","Plan De Pensiones","","Plan De Pensiones","","Pasivos > Activos financieros > Plan De Pensiones","12/10/2024","21:41","","-3,70","EUR","","Pablo; ","4592,97"
"","","Plan De Pensiones","","Plan Pensiones","","Inversiones Ingresos > Plan De Pensiones","09/10/2024","19:17","","30,00","EUR","","Pablo; ","4596,67"
"","","Plan De Pensiones","","Plan De Pensiones","","Pasivos > Activos financieros > Plan De Pensiones","05/10/2024","15:08","","8,17","EUR","","Pablo; ","4566,67"
"","","Plan De Pensiones","","Plan Pensiones","","Inversiones Ingresos > Plan De Pensiones","02/10/2024","19:53","","30,00","EUR","","Pablo; ","4558,50"
"","","Plan De Pensiones","","Plan De Pensiones","","Pasivos > Activos financieros > Plan De Pensiones","30/09/2024","19:07","","5,14","EUR","","Pablo; ","4528,50"
"","","Plan De Pensiones","","Plan De Pensiones","","Pasivos > Activos financieros > Plan De Pensiones","28/09/2024","12:39","","24,06","EUR","","Pablo; ","4523,36"
"","","Plan De Pensiones","","Plan Pensiones","","Inversiones Ingresos > Plan De Pensiones","25/09/2024","22:03","","30,00","EUR","","Pablo; ","4499,30"
"","","Plan De Pensiones","","Plan De Pensiones","","Pasivos > Activos financieros > Plan De Pensiones","21/09/2024","19:12","","15,75","EUR","","Pablo; ","4469,30"
"","","Plan De Pensiones","","Plan Pensiones","","Inversiones Ingresos > Plan De Pensiones","18/09/2024","23:07","","30,00","EUR","","Pablo; ","4453,55"
"","","Plan De Pensiones","","Plan De Pensiones","","Pasivos > Activos financieros > Plan De Pensiones","14/09/2024","22:20","","11,84","EUR","","Pablo; ","4423,55"
"","","Plan De Pensiones","","Plan Pensiones","","Inversiones Ingresos > Plan De Pensiones","11/09/2024","22:17","","30,00","EUR","","Pablo; ","4411,71"
"","","Plan De Pensiones","","Plan Pensiones","","Inversiones Ingresos > Plan De Pensiones","06/09/2024","7:57","","30,00","EUR","","Pablo; ","4381,71"
"","","Plan De Pensiones","","Plan De Pensiones","","Pasivos > Activos financieros > Plan De Pensiones","30/08/2024","17:45","","13,24","EUR","","Pablo; ","4351,71"
"","","Plan De Pensiones","","Plan Pensiones","","Inversiones Ingresos > Plan De Pensiones","28/08/2024","7:20","","30,00","EUR","","Pablo; ","4338,47"
"","","Plan De Pensiones","","Plan De Pensiones","","Pasivos > Activos financieros > Plan De Pensiones","25/08/2024","10:46","","7,42","EUR","","Pablo; ","4308,47"
"","","Plan De Pensiones","","Plan Pensiones","","Inversiones Ingresos > Plan De Pensiones","22/08/2024","20:33","","30,00","EUR","","Pablo; ","4301,05"
"","","Plan De Pensiones","","Plan De Pensiones","","Pasivos > Activos financieros > Plan De Pensiones","18/08/2024","9:56","","47,79","EUR","","Pablo; ","4271,05"
"","","Plan De Pensiones","","Plan Pensiones","","Inversiones Ingresos > Plan De Pensiones","14/08/2024","19:53","","30,00","EUR","","Pablo; ","4223,26"
"","","Plan De Pensiones","","Plan De Pensiones","","Pasivos > Activos financieros > Plan De Pensiones","11/08/2024","21:41","","-56,44","EUR","","Pablo; ","4193,26"
"","","Plan De Pensiones","","Plan Pensiones","","Inversiones Ingresos > Plan De Pensiones","08/08/2024","23:12","","30,00","EUR","","Pablo; ","4249,70"
"","","Plan De Pensiones","","Plan De Pensiones","","Pasivos > Activos financieros > Plan De Pensiones","04/08/2024","10:36","","-3,30","EUR","","Pablo; ","4219,70"
"","","Plan De Pensiones","","Plan De Pensiones","","Pasivos > Activos financieros > Plan De Pensiones","31/07/2024","23:46","","27,90","EUR","","Pablo; ","4223,00"
"","","Plan De Pensiones","","Plan Pensiones","","Inversiones Ingresos > Plan De Pensiones","31/07/2024","23:41","","30,00","EUR","","Pablo; ","4195,10"
"","","Plan De Pensiones","","Plan De Pensiones","","Pasivos > Activos financieros > Plan De Pensiones","27/07/2024","18:35","","-2,39","EUR","","Pablo; ","4165,10"
"","","Plan De Pensiones","","Plan Pensiones","","Inversiones Ingresos > Plan De Pensiones","24/07/2024","20:30","","30,00","EUR","","Pablo; ","4167,49"
"","","Plan De Pensiones","","Plan De Pensiones","","Pasivos > Activos financieros > Plan De Pensiones","21/07/2024","14:07","","-2,64","EUR","","Pablo; ","4137,49"
"","","Plan De Pensiones","","Plan Pensiones","","Inversiones Ingresos > Plan De Pensiones","17/07/2024","19:58","","30,00","EUR","","Pablo; ","4140,13"
"","","Plan De Pensiones","","Plan Pensiones","","Inversiones Ingresos > Plan De Pensiones","11/07/2024","23:52","","30,00","EUR","","Pablo; ","4110,13"
"","","Plan De Pensiones","","Plan De Pensiones","","Pasivos > Activos financieros > Plan De Pensiones","09/07/2024","23:00","","11,05","EUR","","Pablo; ","4080,13"
"","","Plan De Pensiones","","Plan Pensiones","","Inversiones Ingresos > Plan De Pensiones","04/07/2024","22:58","","30,00","EUR","","Pablo; ","4069,08"
"","","Plan De Pensiones","","Plan De Pensiones","","Pasivos > Activos financieros > Plan De Pensiones","30/06/2024","12:06","","-5,98","EUR","","Pablo; ","4039,08"
"","","Plan De Pensiones","","Plan De Pensiones","","Pasivos > Activos financieros > Plan De Pensiones","27/06/2024","7:47","","22,68","EUR","","Pablo; ","4045,06"
"","","Plan De Pensiones","","Plan Pensiones","","Inversiones Ingresos > Plan De Pensiones","26/06/2024","7:46","","30,00","EUR","","Pablo; ","4022,38"
"","","Plan De Pensiones","","Plan Pensiones","","Inversiones Ingresos > Plan De Pensiones","21/06/2024","7:45","","30,00","EUR","","Pablo; ","3992,38"
"","","Plan De Pensiones","","Plan De Pensiones","","Pasivos > Activos financieros > Plan De Pensiones","16/06/2024","13:59","","20,27","EUR","","Pablo; ","3962,38"
"","","Plan De Pensiones","","Plan Pensiones","","Inversiones Ingresos > Plan De Pensiones","13/06/2024","7:38","","30,00","EUR","","Pablo; ","3942,11"
"","","Plan De Pensiones","","Plan De Pensiones","","Pasivos > Activos financieros > Plan De Pensiones","09/06/2024","9:34","","31,21","EUR","","Pablo; ","3912,11"
"","","Plan De Pensiones","","Plan Pensiones","","Inversiones Ingresos > Plan De Pensiones","06/06/2024","20:12","","30,00","EUR","","Pablo; ","3880,90"
"","","Plan De Pensiones","","Plan De Pensiones","","Pasivos > Activos financieros > Plan De Pensiones","31/05/2024","19:43","","-27,67","EUR","","Pablo; ","3850,90"
"","","Plan De Pensiones","","Plan Pensiones","","Inversiones Ingresos > Plan De Pensiones","30/05/2024","6:27","","30,00","EUR","","Pablo; ","3878,57"
"","","Plan De Pensiones","","Plan De Pensiones","","Pasivos > Activos financieros > Plan De Pensiones","25/05/2024","22:36","","-9,38","EUR","","Pablo; ","3848,57"
"","","Plan De Pensiones","","Plan Pensiones","","Inversiones Ingresos > Plan De Pensiones","24/05/2024","22:33","","30,00","EUR","","Pablo; ","3857,95"
"","","Plan De Pensiones","","Plan De Pensiones","","Pasivos > Activos financieros > Plan De Pensiones","18/05/2024","18:53","","22,45","EUR","","Pablo; ","3827,95"
"","","Plan De Pensiones","","Plan Pensiones","","Inversiones Ingresos > Plan De Pensiones","17/05/2024","18:52","","30,00","EUR","","Pablo; ","3805,50"
"","","Plan De Pensiones","","Plan De Pensiones","","Pasivos > Activos financieros > Plan De Pensiones","11/05/2024","7:16","","36,16","EUR","","Pablo; ","3775,50"
"","","Plan De Pensiones","","Plan Pensiones","","Inversiones Ingresos > Plan De Pensiones","09/05/2024","17:35","","90,00","EUR","","Pablo; ","3739,34"
"","","Plan De Pensiones","","Plan De Pensiones","","Pasivos > Activos financieros > Plan De Pensiones","04/05/2024","20:33","","-13,60","EUR","","Pablo; ","3649,34"
"","","Plan De Pensiones","","Plan De Pensiones","","Pasivos > Activos financieros > Plan De Pensiones","30/04/2024","22:55","","33,68","EUR","","Pablo; ","3662,94"
"","","Plan De Pensiones","","Plan De Pensiones","","Pasivos > Activos financieros > Plan De Pensiones","27/04/2024","14:01","","-12,40","EUR","","Pablo; ","3629,26"
"","","Plan De Pensiones","","Plan Pensiones","","Inversiones Ingresos > Plan De Pensiones","23/04/2024","8:01","","30,00","EUR","","Pablo; ","3641,66"
"","","Plan De Pensiones","","Plan De Pensiones","","Pasivos > Activos financieros > Plan De Pensiones","20/04/2024","12:27","","-34,94","EUR","","Pablo; ","3611,66"
"","","Plan De Pensiones","","Plan Pensiones","","Inversiones Ingresos > Plan De Pensiones","16/04/2024","15:05","","30,00","EUR","","Pablo; ","3646,60"
"","","Plan De Pensiones","","Plan De Pensiones","","Pasivos > Activos financieros > Plan De Pensiones","13/04/2024","9:49","","-0,72","EUR","","Pablo; ","3616,60"
"","","Plan De Pensiones","","Plan Pensiones","","Inversiones Ingresos > Plan De Pensiones","09/04/2024","22:05","","30,00","EUR","","Pablo; ","3617,32"
"","","Plan De Pensiones","","Plan De Pensiones","","Pasivos > Activos financieros > Plan De Pensiones","07/04/2024","6:43","","-8,54","EUR","","Pablo; ","3587,32"
"","","Plan De Pensiones","","Plan Pensiones","","Inversiones Ingresos > Plan De Pensiones","03/04/2024","19:38","","30,00","EUR","","Pablo; ","3595,86"
"","","Plan De Pensiones","","Plan De Pensiones","","Pasivos > Activos financieros > Plan De Pensiones","29/03/2024","22:58","","1,42","EUR","","Pablo; ","3565,86"
"","","Plan De Pensiones","","Plan Pensiones","","Inversiones Ingresos > Plan De Pensiones","26/03/2024","22:05","","30,00","EUR","","Pablo; ","3564,44"
"","","Plan De Pensiones","","Plan De Pensiones","","Pasivos > Activos financieros > Plan De Pensiones","22/03/2024","21:41","","31,94","EUR","","Pablo; ","3534,44"
"","","Plan De Pensiones","","Plan Pensiones","","Inversiones Ingresos > Plan De Pensiones","19/03/2024","19:30","","30,00","EUR","","Pablo; ","3502,50"
"","","Plan De Pensiones","","Plan De Pensiones","","Pasivos > Activos financieros > Plan De Pensiones","17/03/2024","14:11","","9,57","EUR","","Pablo; ","3472,50"
"","","Plan De Pensiones","","Plan Pensiones","","Inversiones Ingresos > Plan De Pensiones","12/03/2024","7:31","","30,00","EUR","","Pablo; ","3462,93"
"","","Plan De Pensiones","","Plan De Pensiones","","Pasivos > Activos financieros > Plan De Pensiones","08/03/2024","17:47","","16,61","EUR","","Pablo; ","3432,93"
"","","Plan De Pensiones","","Plan Pensiones","","Inversiones Ingresos > Plan De Pensiones","05/03/2024","17:55","","30,00","EUR","","Pablo; ","3416,32"
"","","Plan De Pensiones","","Plan De Pensiones","","Pasivos > Activos financieros > Plan De Pensiones","03/03/2024","8:50","","4,17","EUR","","Pablo; ","3386,32"
"","","Plan De Pensiones","","Plan De Pensiones","","Pasivos > Activos financieros > Plan De Pensiones","29/02/2024","23:44","","6,16","EUR","","Pablo; ","3382,15"
"","","Plan De Pensiones","","Plan Pensiones","","Inversiones Ingresos > Plan De Pensiones","27/02/2024","23:41","","30,00","EUR","","Pablo; ","3375,99"
"","","Plan De Pensiones","","Plan De Pensiones","","Pasivos > Activos financieros > Plan De Pensiones","24/02/2024","5:53","","-10,18","EUR","","Pablo; ","3345,99"
"","","Plan De Pensiones","","Plan Pensiones","","Inversiones Ingresos > Plan De Pensiones","20/02/2024","9:52","","30,00","EUR","","Pablo; ","3356,17"
"","","Plan De Pensiones","","Plan De Pensiones","","Pasivos > Activos financieros > Plan De Pensiones","16/02/2024","21:20","","7,73","EUR","","Pablo; ","3326,17"
"","","Plan De Pensiones","","Plan Pensiones","","Inversiones Ingresos > Plan De Pensiones","13/02/2024","21:36","","30,00","EUR","","Pablo; ","3318,44"
"","","Plan De Pensiones","","Plan De Pensiones","","Pasivos > Activos financieros > Plan De Pensiones","10/02/2024","7:36","","20,51","EUR","","Pablo; ","3288,44"
"","","Plan De Pensiones","","Plan Pensiones","","Inversiones Ingresos > Plan De Pensiones","07/02/2024","18:07","","30,00","EUR","","Pablo; ","3267,93"
"","","Plan De Pensiones","","Plan De Pensiones","","Pasivos > Activos financieros > Plan De Pensiones","05/02/2024","7:19","","3,98","EUR","","Pablo; ","3237,93"
"","","Plan De Pensiones","","Plan De Pensiones","","Pasivos > Activos financieros > Plan De Pensiones","31/01/2024","19:04","","10,23","EUR","","Pablo; ","3233,95"
"","","Plan De Pensiones","","Plan Pensiones","","Inversiones Ingresos > Plan De Pensiones","30/01/2024","19:01","","30,00","EUR","","Pablo; ","3223,72"
"","","Plan De Pensiones","","Plan De Pensiones","","Pasivos > Activos financieros > Plan De Pensiones","28/01/2024","0:36","","29,94","EUR","","Pablo; ","3193,72"
"","","Plan De Pensiones","","Plan Pensiones","","Inversiones Ingresos > Plan De Pensiones","23/01/2024","15:20","","30,00","EUR","","Pablo; ","3163,78"
"","","Plan De Pensiones","","Plan De Pensiones","","Pasivos > Activos financieros > Plan De Pensiones","20/01/2024","18:06","","2,94","EUR","","Pablo; ","3133,78"
"","","Plan De Pensiones","","Plan Pensiones","","Inversiones Ingresos > Plan De Pensiones","16/01/2024","18:01","","30,00","EUR","","Pablo; ","3130,84"
"","","Plan De Pensiones","","Plan Pensiones","","Inversiones Ingresos > Plan De Pensiones","14/01/2024","19:25","","60,00","EUR","","Pablo; ","3100,84"
"","","Plan De Pensiones","","Plan De Pensiones","","Pasivos > Activos financieros > Plan De Pensiones","14/01/2024","19:09","","-3,93","EUR","","Pablo; ","3040,84"
"","","Plan De Pensiones","","Plan De Pensiones","","Pasivos > Activos financieros > Plan De Pensiones","07/01/2024","10:34","","-8,58","EUR","","Pablo; ","3044,77"
"","","Plan De Pensiones","","Plan De Pensiones","","Pasivos > Activos financieros > Plan De Pensiones","31/12/2023","10:20","","7,60","EUR","","Pablo; ","3053,35"
"","","Plan De Pensiones","","Plan Pensiones","","Inversiones Ingresos > Plan De Pensiones","28/12/2023","23:17","","30,00","EUR","","Pablo; ","3045,75"
"","","Plan De Pensiones","","Plan De Pensiones","","Pasivos > Activos financieros > Plan De Pensiones","23/12/2023","19:45","","26,21","EUR","","Pablo; ","3015,75"
"","","Plan De Pensiones","","Plan Pensiones","","Inversiones Ingresos > Plan De Pensiones","20/12/2023","21:32","","30,00","EUR","","Pablo; ","2989,54"
"","","Plan De Pensiones","","Plan De Pensiones","","Pasivos > Activos financieros > Plan De Pensiones","17/12/2023","16:32","","12,21","EUR","","Pablo; ","2959,54"
"","","Plan De Pensiones","","Fondos","","Inversiones Ingresos > Plan De Pensiones","12/12/2023","22:46","","30,00","EUR","","Pablo; ","2947,33"
"","","Plan De Pensiones","","Plan De Pensiones","","Pasivos > Activos financieros > Plan De Pensiones","08/12/2023","23:36","","27,65","EUR","","Pablo; ","2917,33"
"","","Plan De Pensiones","","Fondos","","Inversiones Ingresos > Plan De Pensiones","05/12/2023","20:59","","30,00","EUR","","Pablo; ","2889,68"
"","","Plan De Pensiones","","Plan De Pensiones","","Pasivos > Activos financieros > Plan De Pensiones","03/12/2023","11:03","","8,64","EUR","","Pablo; ","2859,68"
"","","Plan De Pensiones","","Plan De Pensiones","","Pasivos > Activos financieros > Plan De Pensiones","30/11/2023","22:58","","4,06","EUR","","Pablo; ","2851,04"
"","","Plan De Pensiones","","Plan De Pensiones","","Pasivos > Activos financieros > Plan De Pensiones","30/11/2023","9:45","","-2,65","EUR","","Pablo; ","2846,98"
"","","Plan De Pensiones","","Fondos","","Inversiones Ingresos > Plan De Pensiones","29/11/2023","18:53","","30,00","EUR","","Pablo; ","2849,63"
"","","Plan De Pensiones","","Plan De Pensiones","","Pasivos > Activos financieros > Plan De Pensiones","24/11/2023","21:41","","12,94","EUR","","Pablo; ","2819,63"
"","","Plan De Pensiones","","Fondos","","Inversiones Ingresos > Plan De Pensiones","20/11/2023","21:07","","30,00","EUR","","Pablo; ","2806,69"
"","","Plan De Pensiones","","Plan De Pensiones","","Pasivos > Activos financieros > Plan De Pensiones","18/11/2023","10:04","","13,91","EUR","","Pablo; ","2776,69"
"","","Plan De Pensiones","","Fondos","","Inversiones Ingresos > Plan De Pensiones","14/11/2023","23:22","","30,00","EUR","","Pablo; ","2762,78"
"","","Plan De Pensiones","","Plan De Pensiones","","Pasivos > Activos financieros > Plan De Pensiones","12/11/2023","8:29","","14,79","EUR","","Pablo; ","2732,78"
"","","Plan De Pensiones","","Fondos","","Inversiones Ingresos > Plan De Pensiones","07/11/2023","18:26","","30,00","EUR","","Pablo; ","2717,99"
"","","Plan De Pensiones","","Plan De Pensiones","","Pasivos > Activos financieros > Plan De Pensiones","05/11/2023","13:01","","29,10","EUR","","Pablo; ","2687,99"
"","","Plan De Pensiones","","Plan De Pensiones","","Pasivos > Activos financieros > Plan De Pensiones","31/10/2023","20:01","","2,76","EUR","","Pablo; ","2658,89"
"","","Plan De Pensiones","","Fondos","","Inversiones Ingresos > Plan De Pensiones","31/10/2023","20:00","","30,00","EUR","","Pablo; ","2656,13"
"","","Plan De Pensiones","","Plan De Pensiones","","Pasivos > Activos financieros > Plan De Pensiones","28/10/2023","12:01","","-17,70","EUR","","Pablo; ","2626,13"
"","","Plan De Pensiones","","Fondos","","Inversiones Ingresos > Plan De Pensiones","25/10/2023","22:51","","30,00","EUR","","Pablo; ","2643,83"
"","","Plan De Pensiones","","Plan De Pensiones","","Pasivos > Activos financieros > Plan De Pensiones","22/10/2023","9:41","","-30,75","EUR","","Pablo; ","2613,83"
"","","Plan De Pensiones","","Fondos","","Inversiones Ingresos > Plan De Pensiones","17/10/2023","21:19","","30,00","EUR","","Pablo; ","2644,58"
"","","Plan De Pensiones","","Plan De Pensiones","","Pasivos > Activos financieros > Plan De Pensiones","14/10/2023","20:02","","23,36","EUR","","Pablo; ","2614,58"
"","","Plan De Pensiones","","Fondos","","Inversiones Ingresos > Plan De Pensiones","10/10/2023","20:41","","30,00","EUR","","Pablo; ","2591,22"
"","","Plan De Pensiones","","Plan De Pensiones","","Pasivos > Activos financieros > Plan De Pensiones","07/10/2023","19:10","","-4,26","EUR","","Pablo; ","2561,22"
"","","Plan De Pensiones","","Fondos","","Inversiones Ingresos > Plan De Pensiones","03/10/2023","19:33","","30,00","EUR","","Pablo; ","2565,48"
"","","Plan De Pensiones","","Plan De Pensiones","","Pasivos > Activos financieros > Plan De Pensiones","30/09/2023","7:21","","-1,97","EUR","","Pablo; ","2535,48"
"","","Plan De Pensiones","","Fondos","","Inversiones Ingresos > Plan De Pensiones","27/09/2023","18:14","","30,00","EUR","","Pablo; ","2537,45"
"","","Plan De Pensiones","","Plan De Pensiones","","Pasivos > Activos financieros > Plan De Pensiones","24/09/2023","10:58","","-89,83","EUR","","Pablo; ","2507,45"
"","","Plan De Pensiones","","Fondos","","Inversiones Ingresos > Plan De Pensiones","21/09/2023","18:54","","30,00","EUR","","Pablo; ","2597,28"
"","","Plan De Pensiones","","Plan De Pensiones","","Pasivos > Activos financieros > Plan De Pensiones","16/09/2023","0:01","","33,81","EUR","","Pablo; ","2567,28"
"","","Plan De Pensiones","","Fondos","","Inversiones Ingresos > Plan De Pensiones","13/09/2023","7:33","","30,00","EUR","","Pablo; ","2533,47"
"","","Plan De Pensiones","","Plan De Pensiones","","Pasivos > Activos financieros > Plan De Pensiones","09/09/2023","13:00","","-8,28","EUR","","Pablo; ","2503,47"
"","","Plan De Pensiones","","Fondos","","Inversiones Ingresos > Plan De Pensiones","08/09/2023","19:57","","30,00","EUR","","Pablo; ","2511,75"
"","","Plan De Pensiones","","Plan De Pensiones","","Pasivos > Activos financieros > Plan De Pensiones","01/09/2023","23:30","","17,22","EUR","","Pablo; ","2481,75"
"","","Plan De Pensiones","","Plan De Pensiones","","Pasivos > Activos financieros > Plan De Pensiones","31/08/2023","12:20","","39,64","EUR","","Pablo; ","2464,53"
"","","Plan De Pensiones","","Fondos","","Inversiones Ingresos > Plan De Pensiones","30/08/2023","18:28","","30,00","EUR","","Pablo; ","2424,89"
"","","Plan De Pensiones","","Fondos","","Inversiones Ingresos > Plan De Pensiones","28/08/2023","19:05","","30,00","EUR","","Pablo; ","2394,89"
"","","Plan De Pensiones","","Plan De Pensiones","","Pasivos > Activos financieros > Plan De Pensiones","26/08/2023","16:01","","28,49","EUR","","Pablo; ","2364,89"
"","","Plan De Pensiones","","Plan De Pensiones","","Pasivos > Activos financieros > Plan De Pensiones","21/08/2023","20:42","","-37,22","EUR","","Pablo; ","2336,40"
"","","Plan De Pensiones","","Fondos","","Inversiones Ingresos > Plan De Pensiones","21/08/2023","15:08","","30,00","EUR","","Pablo; ","2373,62"
"","","Plan De Pensiones","","Plan De Pensiones","","Pasivos > Activos financieros > Plan De Pensiones","14/08/2023","15:48","","-21,33","EUR","","Pablo; ","2343,62"
"","","Plan De Pensiones","","Fondos","","Inversiones Ingresos > Plan De Pensiones","11/08/2023","15:29","","30,00","EUR","","Pablo; ","2364,95"
"","","Plan De Pensiones","","Plan De Pensiones","","Pasivos > Activos financieros > Plan De Pensiones","06/08/2023","11:24","","-30,52","EUR","","Pablo; ","2334,95"
"","","Plan De Pensiones","","Fondos","","Inversiones Ingresos > Plan De Pensiones","03/08/2023","17:54","","30,00","EUR","","Pablo; ","2365,47"
"","","Plan De Pensiones","","Plan De Pensiones","","Pasivos > Activos financieros > Plan De Pensiones","31/07/2023","20:14","","4,08","EUR","","Pablo; ","2335,47"
"","","Plan De Pensiones","","Plan De Pensiones","","Pasivos > Activos financieros > Plan De Pensiones","29/07/2023","11:41","","40,00","EUR","","Pablo; ","2331,39"
"","","Plan De Pensiones","","Fondos","","Inversiones Ingresos > Plan De Pensiones","27/07/2023","20:58","","30,00","EUR","","Pablo; ","2291,39"
"","","Plan De Pensiones","","Fondos","","Inversiones Ingresos > Plan De Pensiones","25/07/2023","17:22","","30,00","EUR","","Pablo; ","2261,39"
"","","Plan De Pensiones","","Plan De Pensiones","","Pasivos > Activos financieros > Plan De Pensiones","23/07/2023","6:04","","33,97","EUR","","Pablo; ","2231,39"
"","","Plan De Pensiones","","Plan De Pensiones","","Pasivos > Activos financieros > Plan De Pensiones","16/07/2023","11:12","","-12,05","EUR","","Pablo; ","2197,42"
"","","Plan De Pensiones","","Fondos","","Inversiones Ingresos > Plan De Pensiones","13/07/2023","6:35","","30,00","EUR","","Pablo; ","2209,47"
"","","Plan De Pensiones","","Plan De Pensiones","","Pasivos > Activos financieros > Plan De Pensiones","09/07/2023","18:58","","-22,21","EUR","","Pablo; ","2179,47"
"","","Plan De Pensiones","","Fondos","","Inversiones Ingresos > Plan De Pensiones","06/07/2023","20:27","","30,00","EUR","","Pablo; ","2201,68"
"","","Plan De Pensiones","","Plan De Pensiones","","Pasivos > Activos financieros > Plan De Pensiones","30/06/2023","7:59","","5,13","EUR","","Pablo; ","2171,68"
"","","Plan De Pensiones","","Fondos","","Inversiones Ingresos > Plan De Pensiones","29/06/2023","7:58","","30,00","EUR","","Pablo; ","2166,55"
"","","Plan De Pensiones","","Plan De Pensiones","","Pasivos > Activos financieros > Plan De Pensiones","25/06/2023","9:04","","-13,93","EUR","","Pablo; ","2136,55"
"","","Plan De Pensiones","","Fondos","","Inversiones Ingresos > Plan De Pensiones","22/06/2023","19:54","","30,00","EUR","","Pablo; ","2150,48"
"","","Plan De Pensiones","","Plan De Pensiones","","Pasivos > Activos financieros > Plan De Pensiones","18/06/2023","9:25","","3,37","EUR","","Pablo; ","2120,48"
"","","Plan De Pensiones","","Fondos","","Inversiones Ingresos > Plan De Pensiones","16/06/2023","9:24","","30,00","EUR","","Pablo; ","2117,11"
"","","Plan De Pensiones","","Plan De Pensiones","","Pasivos > Activos financieros > Plan De Pensiones","11/06/2023","22:41","","3,17","EUR","","Pablo; ","2087,11"
"","","Plan De Pensiones","","Fondos","","Inversiones Ingresos > Plan De Pensiones","07/06/2023","22:05","","30,00","EUR","","Pablo; ","2083,94"
"","","Plan De Pensiones","","Plan De Pensiones","","Pasivos > Activos financieros > Plan De Pensiones","02/06/2023","18:52","","17,82","EUR","","Pablo; ","2053,94"
"","","Plan De Pensiones","","Fondos","","Inversiones Ingresos > Plan De Pensiones","01/06/2023","18:50","","30,00","EUR","","Pablo; ","2036,12"
"","","Plan De Pensiones","","Plan De Pensiones","","Pasivos > Activos financieros > Plan De Pensiones","28/05/2023","17:26","","-9,52","EUR","","Pablo; ","2006,12"
"","","Plan De Pensiones","","Fondos","","Inversiones Ingresos > Plan De Pensiones","25/05/2023","8:49","","30,00","EUR","","Pablo; ","2015,64"
"","","Plan De Pensiones","","Plan De Pensiones","","Pasivos > Activos financieros > Plan De Pensiones","21/05/2023","13:28","","16,06","EUR","","Pablo; ","1985,64"
"","","Plan De Pensiones","","Fondos","","Inversiones Ingresos > Plan De Pensiones","19/05/2023","13:25","","30,00","EUR","","Pablo; ","1969,58"
"","","Plan De Pensiones","","Fondos","","Inversiones Ingresos > Plan De Pensiones","10/05/2023","22:53","","30,00","EUR","","Pablo; ","1939,58"
"","","Plan De Pensiones","","Plan De Pensiones","","Pasivos > Activos financieros > Plan De Pensiones","07/05/2023","11:30","","2,53","EUR","","Pablo; ","1909,58"
"","","Plan De Pensiones","","Fondos","","Inversiones Ingresos > Plan De Pensiones","05/05/2023","11:55","","30,00","EUR","","Pablo; ","1907,05"
"","","Plan De Pensiones","","Plan De Pensiones","","Pasivos > Activos financieros > Plan De Pensiones","30/04/2023","14:55","","-4,65","EUR","","Pablo; ","1877,05"
"","","Plan De Pensiones","","Fondos","","Inversiones Ingresos > Plan De Pensiones","26/04/2023","19:03","","30,00","EUR","","Pablo; ","1881,70"
"","","Plan De Pensiones","","Plan De Pensiones","","Pasivos > Activos financieros > Plan De Pensiones","23/04/2023","19:41","","-2,62","EUR","","Pablo; ","1851,70"
"","","Plan De Pensiones","","Fondos","","Inversiones Ingresos > Plan De Pensiones","19/04/2023","20:00","","30,00","EUR","","Pablo; ","1854,32"
"","","Plan De Pensiones","","Plan De Pensiones","","Pasivos > Activos financieros > Plan De Pensiones","16/04/2023","17:17","","-1,06","EUR","","Pablo; ","1824,32"
"","","Plan De Pensiones","","Fondos","","Inversiones Ingresos > Plan De Pensiones","13/04/2023","7:08","","30,00","EUR","","Pablo; ","1825,38"
"","","Plan De Pensiones","","Fondos","","Inversiones Ingresos > Plan De Pensiones","12/04/2023","7:08","","30,00","EUR","","Pablo; ","1795,38"
"","","Plan De Pensiones","","Plan De Pensiones","","Pasivos > Activos financieros > Plan De Pensiones","09/04/2023","13:40","","1,20","EUR","","Pablo; ","1765,38"
"","","Plan De Pensiones","","Plan De Pensiones","","Pasivos > Activos financieros > Plan De Pensiones","04/04/2023","9:05","","5,71","EUR","","Pablo; ","1764,18"
"","","Plan De Pensiones","","Plan De Pensiones","","Pasivos > Activos financieros > Plan De Pensiones","31/03/2023","20:17","","3,31","EUR","","Pablo; ","1758,47"
"","","Plan De Pensiones","","Fondos","","Inversiones Ingresos > Plan De Pensiones","29/03/2023","22:06","","30,00","EUR","","Pablo; ","1755,16"
"","","Plan De Pensiones","","Plan De Pensiones","","Pasivos > Activos financieros > Plan De Pensiones","26/03/2023","19:48","","4,31","EUR","","Pablo; ","1725,16"
"","","Plan De Pensiones","","Fondos","","Inversiones Ingresos > Plan De Pensiones","23/03/2023","19:27","","30,00","EUR","","Pablo; ","1720,85"
"","","Plan De Pensiones","","Plan De Pensiones","","Pasivos > Activos financieros > Plan De Pensiones","19/03/2023","12:01","","-6,11","EUR","","Pablo; ","1690,85"
"","","Plan De Pensiones","","Fondos","","Inversiones Ingresos > Plan De Pensiones","13/03/2023","23:05","","30,00","EUR","","Pablo; ","1696,96"
"","","Plan De Pensiones","","Plan De Pensiones","","Pasivos > Activos financieros > Plan De Pensiones","12/03/2023","18:08","","4,12","EUR","","Pablo; ","1666,96"
"","","Plan De Pensiones","","Fondos","","Inversiones Ingresos > Plan De Pensiones","06/03/2023","18:07","","30,00","EUR","","Pablo; ","1662,84"
"","","Plan De Pensiones","","Plan De Pensiones","","Pasivos > Activos financieros > Plan De Pensiones","05/03/2023","18:36","","-7,64","EUR","","Pablo; ","1632,84"
"","","Plan De Pensiones","","Fondos","","Inversiones Ingresos > Plan De Pensiones","01/03/2023","23:13","","30,00","EUR","","Pablo; ","1640,48"
"","","Plan De Pensiones","","Plan De Pensiones","","Pasivos > Activos financieros > Plan De Pensiones","28/02/2023","21:44","","-3,02","EUR","","Pablo; ","1610,48"
"","","Plan De Pensiones","","Plan De Pensiones","","Pasivos > Activos financieros > Plan De Pensiones","26/02/2023","9:37","","-8,04","EUR","","Pablo; ","1613,50"
"","","Plan De Pensiones","","Fondos","","Inversiones Ingresos > Plan De Pensiones","20/02/2023","14:41","","30,00","EUR","","Pablo; ","1621,54"
"","","Plan De Pensiones","","Plan De Pensiones","","Pasivos > Activos financieros > Plan De Pensiones","19/02/2023","9:42","","-5,11","EUR","","Pablo; ","1591,54"
"","","Plan De Pensiones","","Fondos","","Inversiones Ingresos > Plan De Pensiones","17/02/2023","14:19","","30,00","EUR","","Pablo; ","1596,65"
"","","Plan De Pensiones","","Plan De Pensiones","","Pasivos > Activos financieros > Plan De Pensiones","12/02/2023","12:05","","-5,04","EUR","","Pablo; ","1566,65"
"","","Plan De Pensiones","","Fondos","","Inversiones Ingresos > Plan De Pensiones","06/02/2023","18:52","","30,00","EUR","","Pablo; ","1571,69"
"","","Plan De Pensiones","","Plan De Pensiones","","Pasivos > Activos financieros > Plan De Pensiones","05/02/2023","14:53","","9,96","EUR","","Pablo; ","1541,69"
"","","Plan De Pensiones","","Fondos","","Inversiones Ingresos > Plan De Pensiones","30/01/2023","6:40","","30,00","EUR","","Pablo; ","1531,73"
"","","Plan De Pensiones","","Plan De Pensiones","","Pasivos > Activos financieros > Plan De Pensiones","29/01/2023","10:28","","3,98","EUR","","Pablo; ","1501,73"
"","","Plan De Pensiones","","Plan De Pensiones","","Pasivos > Activos financieros > Plan De Pensiones","22/01/2023","14:12","","2,03","EUR","","Pablo; ","1497,75"
"","","Plan De Pensiones","","Plan De Pensiones","","Pasivos > Activos financieros > Plan De Pensiones","15/01/2023","16:14","","26,68","EUR","","Pablo; ","1495,72"
"","","Plan De Pensiones","","Fondos","","Inversiones Ingresos > Plan De Pensiones","04/01/2023","23:14","","30,00","EUR","","Pablo; ","1469,04"
"","","Plan De Pensiones","","Activos financieros","","Pasivos > Activos financieros > Plan De Pensiones","31/12/2022","10:42","","-31,41","EUR","","","1439,04"
"","","Plan De Pensiones","","Fondos","","Inversiones Ingresos > Plan De Pensiones","27/12/2022","21:09","","30,00","EUR","","","1470,45"
"","","Plan De Pensiones","","Fondos","","Inversiones Ingresos > Plan De Pensiones","15/12/2022","21:09","","30,00","EUR","","","1440,45"
"","","Plan De Pensiones","","Fondos","","Inversiones Ingresos > Plan De Pensiones","08/12/2022","21:09","","30,00","EUR","","","1410,45"
"","","Plan De Pensiones","","Fondos","","Inversiones Ingresos > Plan De Pensiones","06/12/2022","7:38","","930,00","EUR","","","1380,45"
"","","Plan De Pensiones","","Fondos","","Inversiones Ingresos > Plan De Pensiones","01/12/2022","21:11","","30,00","EUR","","","450,45"
"","","Plan De Pensiones","","Activos financieros","","Pasivos > Activos financieros > Plan De Pensiones","30/11/2022","19:32","","0,22","EUR","","","420,45"
"","","Plan De Pensiones","","Fondos","","Inversiones Ingresos > Plan De Pensiones","28/11/2022","19:31","","30,00","EUR","","","420,23"
"","","Plan De Pensiones","","Fondos","","Inversiones Ingresos > Plan De Pensiones","21/11/2022","23:09","","30,00","EUR","","","390,23"
"","","Plan De Pensiones","","Fondos","","Inversiones Ingresos > Plan De Pensiones","21/11/2022","10:46","","300,00","EUR","","","360,23"
"","","Plan De Pensiones","","Fondos","","Inversiones Ingresos > Plan De Pensiones","10/11/2022","18:40","","30,00","EUR","","","60,23"
"","","Plan De Pensiones","","Activos financieros","","Pasivos > Activos financieros > Plan De Pensiones","08/11/2022","18:41","","0,23","EUR","","","30,23"
"","","Plan De Pensiones","","Fondos","","Inversiones Ingresos > Plan De Pensiones","03/11/2022","18:39","","30,00","EUR","","","30,00"
"ST Criptos","2115,32","EUR","","","","","","","","","","","",""
"","","ST Criptos","","ST Criptos","","Pasivos > Activos financieros > ST Criptos","11/05/2025","11:40","","205,92","EUR","","Pablo; ","2115,32"
"","","ST Criptos","","ST Criptos","","Pasivos > Activos financieros > ST Criptos","30/04/2025","14:01","","209,44","EUR","","Pablo; ","1909,40"
"","","ST Criptos","","ST Criptos","","Pasivos > Activos financieros > ST Criptos","13/04/2025","14:01","","-33,48","EUR","","Pablo; ","1699,96"
"","","ST Criptos","","ST Criptos","","Pasivos > Activos financieros > ST Criptos","30/03/2025","14:01","","-24,28","EUR","","Pablo; ","1733,44"
"","","ST Criptos","","ST Criptos","","Pasivos > Activos financieros > ST Criptos","23/03/2025","8:16","","-18,19","EUR","","Pablo; ","1757,72"
"","","ST Criptos","","ST Criptos","","Pasivos > Activos financieros > ST Criptos","15/03/2025","22:59","","-27,24","EUR","","Pablo; ","1775,91"
"","","ST Criptos","","ST Criptos","","Pasivos > Activos financieros > ST Criptos","08/03/2025","21:19","","61,70","EUR","","Pablo; ","1803,15"
"","","ST Criptos","","ST Criptos","","Pasivos > Activos financieros > ST Criptos","28/02/2025","7:50","","-379,50","EUR","","Pablo; ","1741,45"
"","","ST Criptos","","ST Criptos","","Pasivos > Activos financieros > ST Criptos","14/02/2025","20:50","","-111,42","EUR","","Pablo; ","2120,95"
"","","ST Criptos","","ST Criptos","","Pasivos > Activos financieros > ST Criptos","31/01/2025","20:50","","-35,02","EUR","","Pablo; ","2232,37"
"","","ST Criptos","","ST Criptos","","Pasivos > Activos financieros > ST Criptos","26/01/2025","21:15","","-8,27","EUR","","Pablo; ","2267,39"
"","","ST Criptos","","ST Criptos","","Pasivos > Activos financieros > ST Criptos","18/01/2025","10:23","","201,29","EUR","","Pablo; ","2275,66"
"","","ST Criptos","","ST Criptos","","Pasivos > Activos financieros > ST Criptos","12/01/2025","21:44","","-75,11","EUR","","Pablo; ","2074,37"
"","","ST Criptos","","ST Criptos","","Pasivos > Activos financieros > ST Criptos","05/01/2025","21:44","","80,02","EUR","","Pablo; ","2149,48"
"","","ST Criptos","","ST Criptos","","Pasivos > Activos financieros > ST Criptos","22/12/2024","21:44","","-111,69","EUR","","Pablo; ","2069,46"
"","","ST Criptos","","ST Criptos","","Pasivos > Activos financieros > ST Criptos","15/12/2024","9:34","","101,39","EUR","","Pablo; ","2181,15"
"","","ST Criptos","","ST Criptos","","Pasivos > Activos financieros > ST Criptos","02/12/2024","18:02","","-8,04","EUR","","Pablo; ","2079,76"
"","","ST Criptos","","ST Criptos","","Pasivos > Activos financieros > ST Criptos","24/11/2024","20:01","","154,37","EUR","","Pablo; ","2087,80"
"","","ST Criptos","","ST Criptos","","Pasivos > Activos financieros > ST Criptos","17/11/2024","20:09","","251,27","EUR","","Pablo; ","1933,43"
"","","ST Criptos","","ST Criptos","","Pasivos > Activos financieros > ST Criptos","10/11/2024","14:55","","69,76","EUR","","Pablo; ","1682,16"
"","","ST Criptos","","ST Criptos","","Pasivos > Activos financieros > ST Criptos","09/11/2024","13:49","","135,54","EUR","","Pablo; ","1612,40"
"","","ST Criptos","","ST Criptos","","Pasivos > Activos financieros > ST Criptos","01/11/2024","18:54","","57,48","EUR","","Pablo; ","1476,86"
"","","ST Criptos","","ST Criptos","","Inversiones Ingresos > ST Criptos","28/10/2024","19:06","","20,00","EUR","","Pablo; ","1419,38"
"","","ST Criptos","","ST Criptos","","Pasivos > Activos financieros > ST Criptos","27/10/2024","19:29","","-4,20","EUR","","Pablo; ","1399,38"
"","","ST Criptos","","ST Criptos","","Inversiones Ingresos > ST Criptos","21/10/2024","22:00","","20,00","EUR","","Pablo; ","1403,58"
"","","ST Criptos","","ST Criptos","","Pasivos > Activos financieros > ST Criptos","19/10/2024","15:36","","56,24","EUR","","Pablo; ","1383,58"
"","","ST Criptos","","ST Criptos","","Pasivos > Activos financieros > ST Criptos","14/10/2024","21:24","","70,33","EUR","","Pablo; ","1327,34"
"","","ST Criptos","","ST Criptos","","Inversiones Ingresos > ST Criptos","14/10/2024","21:24","","40,00","EUR","","Pablo; ","1257,01"
"","","ST Criptos","","ST Criptos","","Pasivos > Activos financieros > ST Criptos","06/10/2024","17:47","","4,15","EUR","","Pablo; ","1217,01"
"","","ST Criptos","","ST Criptos","","Inversiones Ingresos > ST Criptos","03/10/2024","7:25","","20,00","EUR","","Pablo; ","1212,86"
"","","ST Criptos","","ST Criptos","","Pasivos > Activos financieros > ST Criptos","30/09/2024","19:12","","-39,84","EUR","","Pablo; ","1192,86"
"","","ST Criptos","","ST Criptos","","Pasivos > Activos financieros > ST Criptos","28/09/2024","12:32","","42,67","EUR","","Pablo; ","1232,70"
"","","ST Criptos","","ST Criptos","","Pasivos > Activos financieros > ST Criptos","21/09/2024","19:17","","57,72","EUR","","Pablo; ","1190,03"
"","","ST Criptos","","ST Criptos","","Pasivos > Activos financieros > ST Criptos","14/09/2024","22:20","","101,37","EUR","","Pablo; ","1132,31"
"","","ST Criptos","","ST Criptos","","Inversiones Ingresos > ST Criptos","09/09/2024","22:48","","20,00","EUR","","Pablo; ","1030,94"
"","","ST Criptos","","ST Criptos","","Pasivos > Activos financieros > ST Criptos","08/09/2024","10:59","","-71,19","EUR","","Pablo; ","1010,94"
"","","ST Criptos","","ST Criptos","","Pasivos > Activos financieros > ST Criptos","30/08/2024","17:58","","-94,61","EUR","","Pablo; ","1082,13"
"","","ST Criptos","","ST Criptos","","Pasivos > Activos financieros > ST Criptos","25/08/2024","11:09","","65,02","EUR","","Pablo; ","1176,74"
"","","ST Criptos","","ST Criptos","","Inversiones Ingresos > ST Criptos","22/08/2024","20:36","","13,67","EUR","","Pablo; ","1111,72"
"","","ST Criptos","","ST Criptos","","Pasivos > Activos financieros > ST Criptos","18/08/2024","9:54","","-14,71","EUR","","Pablo; ","1098,05"
"","","ST Criptos","","ST Criptos","","Inversiones Ingresos > ST Criptos","13/08/2024","19:36","","13,67","EUR","","Pablo; ","1112,76"
"","","ST Criptos","","ST Criptos","","Pasivos > Activos financieros > ST Criptos","11/08/2024","21:38","","16,73","EUR","","Pablo; ","1099,09"
"","","ST Criptos","","ST Criptos","","Pasivos > Activos financieros > ST Criptos","04/08/2024","19:03","","-104,00","EUR","","Pablo; ","1082,36"
"","","ST Criptos","","ST Criptos","","Inversiones Ingresos > ST Criptos","04/08/2024","19:02","","13,93","EUR","","Pablo; ","1186,36"
"","","ST Criptos","","ST Criptos","","Pasivos > Activos financieros > ST Criptos","31/07/2024","23:03","","-64,30","EUR","","Pablo; ","1172,43"
"","","ST Criptos","","ST Criptos","","Inversiones Ingresos > ST Criptos","29/07/2024","18:27","","13,93","EUR","","Pablo; ","1236,73"
"","","ST Criptos","","ST Criptos","","Pasivos > Activos financieros > ST Criptos","28/07/2024","22:28","","16,38","EUR","","Pablo; ","1222,80"
"","","ST Criptos","","ST Criptos","","Inversiones Ingresos > ST Criptos","24/07/2024","7:20","","13,93","EUR","","Pablo; ","1206,42"
"","","ST Criptos","","ST Criptos","","Pasivos > Activos financieros > ST Criptos","21/07/2024","14:12","","62,23","EUR","","Pablo; ","1192,49"
"","","ST Criptos","","ST Criptos","","Pasivos > Activos financieros > ST Criptos","15/07/2024","22:32","","60,00","EUR","","Pablo; ","1130,26"
"","","ST Criptos","","ST Criptos","","Inversiones Ingresos > ST Criptos","15/07/2024","22:31","","13,93","EUR","","Pablo; ","1070,26"
"","","ST Criptos","","ST Criptos","","Pasivos > Activos financieros > ST Criptos","14/07/2024","17:59","","44,92","EUR","","Pablo; ","1056,33"
"","","ST Criptos","","ST Criptos","","Pasivos > Activos financieros > ST Criptos","09/07/2024","6:25","","-88,50","EUR","","Pablo; ","1011,41"
"","","ST Criptos","","ST Criptos","","Inversiones Ingresos > ST Criptos","09/07/2024","6:25","","13,93","EUR","","Pablo; ","1099,91"
"","","ST Criptos","","ST Criptos","","Inversiones Ingresos > ST Criptos","03/07/2024","17:42","","13,93","EUR","","Pablo; ","1085,98"
"","","ST Criptos","","ST Criptos","","Pasivos > Activos financieros > ST Criptos","30/06/2024","12:13","","9,14","EUR","","Pablo; ","1072,05"
"","","ST Criptos","","ST Criptos","","Pasivos > Activos financieros > ST Criptos","27/06/2024","7:49","","-94,51","EUR","","Pablo; ","1062,91"
"","","ST Criptos","","ST Criptos","","Inversiones Ingresos > ST Criptos","24/06/2024","7:48","","13,93","EUR","","Pablo; ","1157,42"
"","","ST Criptos","","ST Criptos","","Inversiones Ingresos > ST Criptos","17/06/2024","19:27","","13,93","EUR","","Pablo; ","1143,49"
"","","ST Criptos","","ST Criptos","","Pasivos > Activos financieros > ST Criptos","16/06/2024","14:05","","-36,44","EUR","","Pablo; ","1129,56"
"","","ST Criptos","","ST Criptos","","Inversiones Ingresos > ST Criptos","10/06/2024","20:11","","13,93","EUR","","Pablo; ","1166,00"
"","","ST Criptos","","ST Criptos","","Pasivos > Activos financieros > ST Criptos","09/06/2024","9:39","","8,51","EUR","","Pablo; ","1152,07"
"","","ST Criptos","","ST Criptos","","Inversiones Ingresos > ST Criptos","05/06/2024","23:23","","13,93","EUR","","Pablo; ","1143,56"
"","","ST Criptos","","ST Criptos","","Inversiones Ingresos > ST Criptos","01/06/2024","23:24","","13,93","EUR","","Pablo; ","1129,63"
"","","ST Criptos","","ST Criptos","","Pasivos > Activos financieros > ST Criptos","26/05/2024","14:54","","36,62","EUR","","Pablo; ","1115,70"
"","","ST Criptos","","ST Criptos","","Inversiones Ingresos > ST Criptos","20/05/2024","18:42","","13,93","EUR","","Pablo; ","1079,08"
"","","ST Criptos","","ST Criptos","","Pasivos > Activos financieros > ST Criptos","18/05/2024","18:55","","80,59","EUR","","Pablo; ","1065,15"
"","","ST Criptos","","ST Criptos","","Inversiones Ingresos > ST Criptos","13/05/2024","22:10","","13,93","EUR","","Pablo; ","984,56"
"","","ST Criptos","","ST Criptos","","Pasivos > Activos financieros > ST Criptos","12/05/2024","23:07","","4,62","EUR","","Pablo; ","970,63"
"","","ST Criptos","","ST Criptos","","Pasivos > Activos financieros > ST Criptos","12/05/2024","8:53","","-47,12","EUR","","Pablo; ","966,01"
"","","ST Criptos","","ST Criptos","","Inversiones Ingresos > ST Criptos","06/05/2024","8:12","","13,93","EUR","","Pablo; ","1013,13"
"","","ST Criptos","","ST Criptos","","Pasivos > Activos financieros > ST Criptos","05/05/2024","14:11","","52,31","EUR","","Pablo; ","999,20"
"","","ST Criptos","","ST Criptos","","Pasivos > Activos financieros > ST Criptos","30/04/2024","21:25","","-59,60","EUR","","Pablo; ","946,89"
"","","ST Criptos","","ST Criptos","","Pasivos > Activos financieros > ST Criptos","28/04/2024","8:15","","-68,78","EUR","","Pablo; ","1006,49"
"","","ST Criptos","","ST Criptos","","Inversiones Ingresos > ST Criptos","28/04/2024","8:01","","13,93","EUR","","Pablo; ","1075,27"
"","","ST Criptos","","ST Criptos","","Inversiones Ingresos > ST Criptos","15/04/2024","22:02","","13,93","EUR","","Pablo; ","1061,34"
"","","ST Criptos","","ST Criptos","","Inversiones Ingresos > ST Criptos","08/04/2024","7:27","","13,93","EUR","","Pablo; ","1047,41"
"","","ST Criptos","","ST Criptos","","Pasivos > Activos financieros > ST Criptos","07/04/2024","12:01","","-6,84","EUR","","Pablo; ","1033,48"
"","","ST Criptos","","ST Criptos","","Inversiones Ingresos > ST Criptos","02/04/2024","12:00","","13,93","EUR","","Pablo; ","1040,32"
"","","ST Criptos","","ST Criptos","","Pasivos > Activos financieros > ST Criptos","29/03/2024","23:01","","49,60","EUR","","Pablo; ","1026,39"
"","","ST Criptos","","ST Criptos","","Inversiones Ingresos > ST Criptos","25/03/2024","10:15","","13,93","EUR","","Pablo; ","976,79"
"","","ST Criptos","","ST Criptos","","Pasivos > Activos financieros > ST Criptos","24/03/2024","21:46","","40,16","EUR","","Pablo; ","962,86"
"","","ST Criptos","","ST Criptos","","Pasivos > Activos financieros > ST Criptos","22/03/2024","21:53","","-49,84","EUR","","Pablo; ","922,70"
"","","ST Criptos","","ST Criptos","","Inversiones Ingresos > ST Criptos","18/03/2024","12:18","","13,93","EUR","","Pablo; ","972,54"
"","","ST Criptos","","ST Criptos","","Pasivos > Activos financieros > ST Criptos","17/03/2024","15:56","","-22,82","EUR","","Pablo; ","958,61"
"","","ST Criptos","","ST Criptos","","Inversiones Ingresos > ST Criptos","11/03/2024","7:15","","13,93","EUR","","Pablo; ","981,43"
"","","ST Criptos","","ST Criptos","","Pasivos > Activos financieros > ST Criptos","10/03/2024","21:56","","21,98","EUR","","Pablo; ","967,50"
"","","ST Criptos","","ST Criptos","","Pasivos > Activos financieros > ST Criptos","08/03/2024","18:01","","76,49","EUR","","Pablo; ","945,52"
"","","ST Criptos","","ST Criptos","","Inversiones Ingresos > ST Criptos","04/03/2024","14:14","","13,93","EUR","","Pablo; ","869,03"
"","","ST Criptos","","ST Criptos","","Pasivos > Activos financieros > ST Criptos","03/03/2024","9:00","","6,36","EUR","","Pablo; ","855,10"
"","","ST Criptos","","ST Criptos","","Pasivos > Activos financieros > ST Criptos","29/02/2024","23:55","","124,72","EUR","","Pablo; ","848,74"
"","","ST Criptos","","ST Criptos","","Inversiones Ingresos > ST Criptos","26/02/2024","22:47","","13,93","EUR","","Pablo; ","724,02"
"","","ST Criptos","","ST Criptos","","Inversiones Ingresos > ST Criptos","19/02/2024","14:23","","13,93","EUR","","Pablo; ","710,09"
"","","ST Criptos","","ST Criptos","","Pasivos > Activos financieros > ST Criptos","18/02/2024","17:46","","50,15","EUR","","Pablo; ","696,16"
"","","ST Criptos","","ST Criptos","","Inversiones Ingresos > ST Criptos","12/02/2024","8:39","","13,90","EUR","","Pablo; ","646,01"
"","","ST Criptos","","ST Criptos","","Pasivos > Activos financieros > ST Criptos","11/02/2024","21:49","","10,19","EUR","","Pablo; ","632,11"
"","","ST Criptos","","ST Criptos","","Pasivos > Activos financieros > ST Criptos","10/02/2024","7:46","","53,76","EUR","","Pablo; ","621,92"
"","","ST Criptos","","ST Criptos","","Inversiones Ingresos > ST Criptos","05/02/2024","7:45","","13,70","EUR","","Pablo; ","568,16"
"","","ST Criptos","","ST Criptos","","Inversiones Ingresos > ST Criptos","01/02/2024","13:12","","13,70","EUR","","Pablo; ","554,46"
"","","ST Criptos","","ST Criptos","","Inversiones Ingresos > ST Criptos","22/01/2024","13:12","","13,78","EUR","","Pablo; ","540,76"
"","","ST Criptos","","ST Criptos","","Inversiones Ingresos > ST Criptos","15/01/2024","6:36","","13,68","EUR","","Pablo; ","526,98"
"","","ST Criptos","","ST Criptos","","Inversiones Ingresos > ST Criptos","10/01/2024","21:58","","13,69","EUR","","Pablo; ","513,30"
"","","ST Criptos","","ST Criptos","","Pasivos > Activos financieros > ST Criptos","07/01/2024","11:06","","18,59","EUR","","Pablo; ","499,61"
"","","ST Criptos","","ST Criptos","","Inversiones Ingresos > ST Criptos","03/01/2024","11:05","","13,74","EUR","","Pablo; ","481,02"
"","","ST Criptos","","ST Criptos","","Pasivos > Activos financieros > ST Criptos","31/12/2023","10:31","","-8,83","EUR","","Pablo; ","467,28"
"","","ST Criptos","","ST Criptos","","Pasivos > Activos financieros > ST Criptos","25/12/2023","21:23","","8,43","EUR","","Pablo; ","476,11"
"","","ST Criptos","","ST Criptos","","Inversiones Ingresos > ST Criptos","25/12/2023","21:21","","13,61","EUR","","Pablo; ","467,68"
"","","ST Criptos","","ST Criptos","","Pasivos > Activos financieros > ST Criptos","17/12/2023","21:33","","-10,63","EUR","","Pablo; ","454,07"
"","","ST Criptos","","ST Criptos","","Pasivos > Activos financieros > ST Criptos","10/12/2023","17:18","","-4,94","EUR","","Pablo; ","464,70"
"","","ST Criptos","","ST Criptos","","Pasivos > Activos financieros > ST Criptos","08/12/2023","23:46","","74,39","EUR","","Pablo; ","469,64"
"","","ST Criptos","","ST Criptos","","Pasivos > Activos financieros > ST Criptos","30/11/2023","22:54","","-0,18","EUR","","Pablo; ","395,25"
"","","ST Criptos","","ST Criptos","","Pasivos > Activos financieros > ST Criptos","12/11/2023","8:54","","21,35","EUR","","Pablo; ","395,43"
"","","ST Criptos","","ST Criptos","","Inversiones Ingresos > ST Criptos","05/11/2023","14:25","","374,08","EUR","","Pablo; ","374,08"
"","","ST Criptos","","ST Criptos","","Inversiones Ingresos > ST Criptos","02/11/2023","6:25","","-72,81","EUR","","Pablo; ","-0,00"
"","","ST Criptos","","ST Criptos","","Pasivos > Activos financieros > ST Criptos","02/11/2023","6:25","","1,26","EUR","","Pablo; ","72,81"
"","","ST Criptos","","ST Criptos","","Pasivos > Activos financieros > ST Criptos","31/10/2023","20:19","","0,97","EUR","","Pablo; ","71,55"
"","","ST Criptos","","ST Criptos","","Pasivos > Activos financieros > ST Criptos","29/10/2023","10:53","","-1,27","EUR","","Pablo; ","70,58"
"","","ST Criptos","","ST Criptos","","Inversiones Ingresos > ST Criptos","25/10/2023","0:22","","71,85","EUR","","Pablo; ","71,85"
"","","ST Criptos","","ST Criptos","","Inversiones Ingresos > ST Criptos","25/10/2023","0:22","","-142,52","EUR","","Pablo; ","-0,00"
"","","ST Criptos","","ST Criptos","","Pasivos > Activos financieros > ST Criptos","25/10/2023","0:21","","0,65","EUR","","Pablo; ","142,52"
"","","ST Criptos","","ST Criptos","","Inversiones Ingresos > ST Criptos","25/10/2023","0:20","","141,87","EUR","","Pablo; ","141,87"
"","","ST Criptos","","ST Criptos","","Inversiones Ingresos > ST Criptos","25/10/2023","0:12","","-70,01","EUR","","Pablo; ","-0,00"
"","","ST Criptos","","ST Criptos","","Pasivos > Activos financieros > ST Criptos","24/10/2023","10:42","","0,38","EUR","","Pablo; ","70,01"
"","","ST Criptos","","ST Criptos","","Inversiones Ingresos > ST Criptos","24/10/2023","0:08","","69,63","EUR","","Pablo; ","69,63"
"","","ST Criptos","","ST Criptos","","Inversiones Ingresos > ST Criptos","30/09/2023","23:57","","-845,94","EUR","","","-0,00"
"","","ST Criptos","","Criptos","","Pasivos > Activos financieros > ST Criptos","30/09/2023","23:56","","-1,13","EUR","","Pablo; ","845,94"
"","","ST Criptos","","Criptos","","Pasivos > Activos financieros > ST Criptos","30/09/2023","9:53","","14,24","EUR","","Pablo; ","847,07"
"","","ST Criptos","","Bot Automático Pionex","","Inversiones Ingresos > ST Criptos","26/09/2023","23:30","","58,48","EUR","","Pablo; ","832,83"
"","","ST Criptos","","Criptos","","Pasivos > Activos financieros > ST Criptos","24/09/2023","10:57","","-3,25","EUR","","Pablo; ","774,35"
"","","ST Criptos","","Criptos","","Inversiones Ingresos > ST Criptos","21/09/2023","19:16","","15,00","EUR","","Pablo; ","777,60"
"","","ST Criptos","","Criptos","","Pasivos > Activos financieros > ST Criptos","16/09/2023","0:03","","10,77","EUR","","Pablo; ","762,60"
"","","ST Criptos","","Criptos","","Inversiones Ingresos > ST Criptos","12/09/2023","18:23","","150,00","EUR","","Pablo; ","751,83"
"","","ST Criptos","","Criptos","","Pasivos > Activos financieros > ST Criptos","10/09/2023","22:24","","-1,90","EUR","","Pablo; ","601,83"
"","","ST Criptos","","Criptos","","Pasivos > Activos financieros > ST Criptos","09/09/2023","13:02","","1,77","EUR","","Pablo; ","603,73"
"","","ST Criptos","","Criptos","","Inversiones Ingresos > ST Criptos","05/09/2023","23:31","","15,00","EUR","","Pablo; ","601,96"
"","","ST Criptos","","Criptos","","Pasivos > Activos financieros > ST Criptos","03/09/2023","22:23","","4,84","EUR","","Pablo; ","586,96"
"","","ST Criptos","","Criptos","","Pasivos > Activos financieros > ST Criptos","01/09/2023","23:30","","-9,19","EUR","","Pablo; ","582,12"
"","","ST Criptos","","Criptos","","Pasivos > Activos financieros > ST Criptos","31/08/2023","12:22","","2,17","EUR","","Pablo; ","591,31"
"","","ST Criptos","","Criptos","","Pasivos > Activos financieros > ST Criptos","27/08/2023","10:59","","3,68","EUR","","Pablo; ","589,14"
"","","ST Criptos","","Criptos","","Inversiones Ingresos > ST Criptos","24/08/2023","16:44","","15,00","EUR","","Pablo; ","585,46"
"","","ST Criptos","","Criptos","","Pasivos > Activos financieros > ST Criptos","21/08/2023","20:43","","-70,04","EUR","","Pablo; ","570,46"
"","","ST Criptos","","Criptos","","Pasivos > Activos financieros > ST Criptos","14/08/2023","15:49","","11,56","EUR","","Pablo; ","640,50"
"","","ST Criptos","","Criptos","","Inversiones Ingresos > ST Criptos","08/08/2023","21:03","","15,00","EUR","","Pablo; ","628,94"
"","","ST Criptos","","Criptos","","Pasivos > Activos financieros > ST Criptos","06/08/2023","11:26","","-5,00","EUR","","Pablo; ","613,94"
"","","ST Criptos","","Criptos","","Pasivos > Activos financieros > ST Criptos","31/07/2023","20:14","","-2,92","EUR","","Pablo; ","618,94"
"","","ST Criptos","","Criptos","","Pasivos > Activos financieros > ST Criptos","31/07/2023","6:52","","1,51","EUR","","Pablo; ","621,86"
"","","ST Criptos","","Criptos","","Pasivos > Activos financieros > ST Criptos","30/07/2023","11:43","","-8,40","EUR","","Pablo; ","620,35"
"","","ST Criptos","","Criptos","","Inversiones Ingresos > ST Criptos","25/07/2023","17:28","","15,00","EUR","","Pablo; ","628,75"
"","","ST Criptos","","Criptos","","Pasivos > Activos financieros > ST Criptos","23/07/2023","6:27","","0,29","EUR","","Pablo; ","613,75"
"","","ST Criptos","","Criptos","","Pasivos > Activos financieros > ST Criptos","16/07/2023","9:50","","-9,48","EUR","","Pablo; ","613,46"
"","","ST Criptos","","Criptos","","Inversiones Ingresos > ST Criptos","14/07/2023","7:37","","15,00","EUR","","Pablo; ","622,94"
"","","ST Criptos","","Criptos","","Pasivos > Activos financieros > ST Criptos","09/07/2023","18:57","","-10,10","EUR","","Pablo; ","607,94"
"","","ST Criptos","","Criptos","","Pasivos > Activos financieros > ST Criptos","02/07/2023","20:54","","-3,01","EUR","","Pablo; ","618,04"
"","","ST Criptos","","Criptos","","Pasivos > Activos financieros > ST Criptos","30/06/2023","8:00","","-2,73","EUR","","Pablo; ","621,05"
"","","ST Criptos","","Criptos","","Inversiones Ingresos > ST Criptos","27/06/2023","20:21","","15,00","EUR","","Pablo; ","623,78"
"","","ST Criptos","","Criptos","","Pasivos > Activos financieros > ST Criptos","25/06/2023","9:06","","77,50","EUR","","Pablo; ","608,78"
"","","ST Criptos","","Criptos","","Pasivos > Activos financieros > ST Criptos","18/06/2023","9:26","","-6,95","EUR","","Pablo; ","531,28"
"","","ST Criptos","","Criptos","","Inversiones Ingresos > ST Criptos","14/06/2023","11:05","","15,00","EUR","","Pablo; ","538,23"
"","","ST Criptos","","Criptos","","Pasivos > Activos financieros > ST Criptos","11/06/2023","22:42","","-28,80","EUR","","Pablo; ","523,23"
"","","ST Criptos","","Criptos","","Pasivos > Activos financieros > ST Criptos","04/06/2023","18:16","","1,60","EUR","","Pablo; ","552,03"
"","","ST Criptos","","Criptos","","Pasivos > Activos financieros > ST Criptos","02/06/2023","18:46","","3,28","EUR","","Pablo; ","550,43"
"","","ST Criptos","","Criptos","","Inversiones Ingresos > ST Criptos","02/06/2023","18:46","","15,00","EUR","","Pablo; ","547,15"
"","","ST Criptos","","Criptos","","Pasivos > Activos financieros > ST Criptos","28/05/2023","17:24","","11,70","EUR","","Pablo; ","532,15"
"","","ST Criptos","","Criptos","","Pasivos > Activos financieros > ST Criptos","21/05/2023","13:23","","3,82","EUR","","Pablo; ","520,45"
"","","ST Criptos","","Criptos","","Inversiones Ingresos > ST Criptos","18/05/2023","6:54","","15,00","EUR","","Pablo; ","516,63"
"","","ST Criptos","","Criptos","","Pasivos > Activos financieros > ST Criptos","14/05/2023","21:54","","-19,10","EUR","","Pablo; ","501,63"
"","","ST Criptos","","Criptos","","Pasivos > Activos financieros > ST Criptos","07/05/2023","11:30","","-10,60","EUR","","Pablo; ","520,73"
"","","ST Criptos","","Criptos","","Inversiones Ingresos > ST Criptos","05/05/2023","11:50","","15,00","EUR","","Pablo; ","531,33"
"","","ST Criptos","","Criptos","","Pasivos > Activos financieros > ST Criptos","30/04/2023","14:53","","24,01","EUR","","Pablo; ","516,33"
"","","ST Criptos","","Criptos","","Pasivos > Activos financieros > ST Criptos","23/04/2023","19:39","","-58,23","EUR","","Pablo; ","492,32"
"","","ST Criptos","","Criptos","","Inversiones Ingresos > ST Criptos","19/04/2023","11:48","","15,00","EUR","","Pablo; ","550,55"
"","","ST Criptos","","Criptos","","Pasivos > Activos financieros > ST Criptos","16/04/2023","17:17","","46,70","EUR","","Pablo; ","535,55"
"","","ST Criptos","","Criptos","","Pasivos > Activos financieros > ST Criptos","09/04/2023","13:36","","-1,41","EUR","","Pablo; ","488,85"
"","","ST Criptos","","Criptos","","Inversiones Ingresos > ST Criptos","04/04/2023","18:38","","15,00","EUR","","Pablo; ","490,26"
"","","ST Criptos","","Criptos","","Pasivos > Activos financieros > ST Criptos","04/04/2023","9:05","","-4,70","EUR","","Pablo; ","475,26"
"","","ST Criptos","","Criptos","","Pasivos > Activos financieros > ST Criptos","31/03/2023","20:19","","6,34","EUR","","Pablo; ","479,96"
"","","ST Criptos","","Criptos","","Pasivos > Activos financieros > ST Criptos","26/03/2023","19:49","","6,09","EUR","","Pablo; ","473,62"
"","","ST Criptos","","Criptos","","Inversiones Ingresos > ST Criptos","21/03/2023","19:49","","15,00","EUR","","Pablo; ","467,53"
"","","ST Criptos","","Criptos","","Pasivos > Activos financieros > ST Criptos","19/03/2023","12:02","","97,62","EUR","","Pablo; ","452,53"
"","","ST Criptos","","Criptos","","Pasivos > Activos financieros > ST Criptos","12/03/2023","18:09","","-33,26","EUR","","Pablo; ","354,91"
"","","ST Criptos","","Criptos","","Inversiones Ingresos > ST Criptos","07/03/2023","21:07","","15,00","EUR","","Pablo; ","388,17"
"","","ST Criptos","","Criptos","","Pasivos > Activos financieros > ST Criptos","05/03/2023","18:37","","-16,11","EUR","","Pablo; ","373,17"
"","","ST Criptos","","Criptos","","Pasivos > Activos financieros > ST Criptos","28/02/2023","21:54","","3,18","EUR","","Compartido; ","389,28"
"","","ST Criptos","","Criptos","","Inversiones Ingresos > ST Criptos","27/02/2023","13:13","","15,00","EUR","","Compartido; ","386,10"
"","","ST Criptos","","Criptos","","Pasivos > Activos financieros > ST Criptos","26/02/2023","9:38","","-18,83","EUR","","Compartido; ","371,10"
"","","ST Criptos","","Criptos","","Inversiones Ingresos > ST Criptos","20/02/2023","14:38","","15,00","EUR","","Compartido; ","389,93"
"","","ST Criptos","","Criptos","","Pasivos > Activos financieros > ST Criptos","19/02/2023","9:38","","39,26","EUR","","Compartido; ","374,93"
"","","ST Criptos","","Criptos","","Inversiones Ingresos > ST Criptos","13/02/2023","20:00","","15,00","EUR","","Compartido; ","335,67"
"","","ST Criptos","","Criptos","","Pasivos > Activos financieros > ST Criptos","12/02/2023","12:06","","-16,99","EUR","","Compartido; ","320,67"
"","","ST Criptos","","Criptos","","Inversiones Ingresos > ST Criptos","06/02/2023","21:40","","15,00","EUR","","Compartido; ","337,66"
"","","ST Criptos","","Criptos","","Pasivos > Activos financieros > ST Criptos","05/02/2023","14:57","","3,57","EUR","","Compartido; ","322,66"
"","","ST Criptos","","Criptos","","Inversiones Ingresos > ST Criptos","30/01/2023","19:01","","15,00","EUR","","Compartido; ","319,09"
"","","ST Criptos","","Criptos","","Pasivos > Activos financieros > ST Criptos","29/01/2023","10:29","","1,08","EUR","","Compartido; ","304,09"
"","","ST Criptos","","Criptos","","Inversiones Ingresos > ST Criptos","23/01/2023","15:02","","15,00","EUR","","Compartido; ","303,01"
"","","ST Criptos","","Criptos","","Pasivos > Activos financieros > ST Criptos","22/01/2023","14:09","","21,88","EUR","","Compartido; ","288,01"
"","","ST Criptos","","Criptos","","Inversiones Ingresos > ST Criptos","16/01/2023","12:00","","15,00","EUR","","Compartido; ","266,13"
"","","ST Criptos","","Criptos","","Pasivos > Activos financieros > ST Criptos","15/01/2023","16:16","","50,23","EUR","","Compartido; ","251,13"
"","","ST Criptos","","Criptos","","Inversiones Ingresos > ST Criptos","02/01/2023","17:20","","15,00","EUR","","Compartido; ","200,90"
"","","ST Criptos","","Activos financieros","","Pasivos > Activos financieros > ST Criptos","31/12/2022","10:46","","-13,16","EUR","","","185,90"
"","","ST Criptos","","Criptos","","Inversiones Ingresos > ST Criptos","19/12/2022","21:28","","15,00","EUR","","","199,06"
"","","ST Criptos","","Criptos","","Inversiones Ingresos > ST Criptos","05/12/2022","21:28","","15,00","EUR","","","184,06"
"","","ST Criptos","","Activos financieros","","Pasivos > Activos financieros > ST Criptos","30/11/2022","19:28","","-42,85","EUR","","","169,06"
"","","ST Criptos","","Criptos","","Inversiones Ingresos > ST Criptos","21/11/2022","22:07","","15,00","EUR","","","211,91"
"","","ST Criptos","","Activos financieros","","Pasivos > Activos financieros > ST Criptos","07/11/2022","18:50","","-0,31","EUR","","","196,91"
"","","ST Criptos","","Criptos","","Inversiones Ingresos > ST Criptos","07/11/2022","18:46","","15,00","EUR","","","197,22"
"","","ST Criptos","","Intereses","","Pasivos > Activos financieros > ST Criptos","31/10/2022","10:35","","8,52","EUR","","","182,22"
"","","ST Criptos","","Intereses","","Pasivos > Activos financieros > ST Criptos","30/09/2022","10:35","","-4,82","EUR","","","173,70"
"","","ST Criptos","","Intereses","","Pasivos > Activos financieros > ST Criptos","31/08/2022","10:35","","-21,83","EUR","","","178,52"
"","","ST Criptos","","Intereses","","Pasivos > Activos financieros > ST Criptos","31/07/2022","10:35","","51,54","EUR","","","200,35"
"","","ST Criptos","","Intereses","","Pasivos > Activos financieros > ST Criptos","30/06/2022","10:35","","-93,82","EUR","","","148,81"
"","","ST Criptos","","Intereses","","Pasivos > Activos financieros > ST Criptos","31/05/2022","10:35","","-74,59","EUR","","","242,63"
"","","ST Criptos","","Intereses","","Pasivos > Activos financieros > ST Criptos","30/04/2022","10:35","","2,03","EUR","","","317,22"
"","","ST Criptos","","Intereses","","Pasivos > Activos financieros > ST Criptos","28/02/2022","10:35","","-67,84","EUR","","","315,19"
"","","ST Criptos","","Criptos","","Inversiones Ingresos > ST Criptos","07/01/2022","10:35","","50,00","EUR","","","383,03"
"","","ST Criptos","","Intereses","","Pasivos > Activos financieros > ST Criptos","31/12/2021","10:35","","41,03","EUR","","","333,03"
"","","ST Criptos","","Criptos","","Inversiones Ingresos > ST Criptos","10/03/2021","10:35","","292,00","EUR","","","292,00"
"ST Stocks (Trade Republic)","1052,23","EUR","","","","","","","","","","","",""
"","","ST Stocks (Trade Republic)","","ST Stocks","","Inversiones Ingresos > ST Stocks","12/05/2025","19:28","","251,00","EUR","","Pablo; ","1052,23"
"","","ST Stocks (Trade Republic)","","ST Stocks","","Inversiones Ingresos > ST Stocks","12/05/2025","19:28","","-404,91","EUR","","Pablo; ","801,23"
"","","ST Stocks (Trade Republic)","","ST Stocks","","Pasivos > Activos financieros > ST Stocks","11/05/2025","11:42","","96,62","EUR","","Pablo; ","1206,14"
"","","ST Stocks (Trade Republic)","","ST Stocks","","Pasivos > Activos financieros > ST Stocks","30/04/2025","23:49","","88,07","EUR","","Pablo; ","1109,52"
"","","ST Stocks (Trade Republic)","","ST Stocks","","Inversiones Ingresos > ST Stocks","17/04/2025","18:05","","251,00","EUR","","Pablo; ","1021,45"
"","","ST Stocks (Trade Republic)","","ST Stocks","","Pasivos > Activos financieros > ST Stocks","13/04/2025","13:56","","-101,21","EUR","","Pablo; ","770,45"
"","","ST Stocks (Trade Republic)","","ST Stocks","","Pasivos > Activos financieros > ST Stocks","30/03/2025","13:56","","13,21","EUR","","Pablo; ","871,66"
"","","ST Stocks (Trade Republic)","","ST Stocks","","Pasivos > Activos financieros > ST Stocks","23/03/2025","8:17","","-54,18","EUR","","Pablo; ","858,45"
"","","ST Stocks (Trade Republic)","","ST Stocks","","Pasivos > Activos financieros > ST Stocks","15/03/2025","23:00","","-27,63","EUR","","Pablo; ","912,63"
"","","ST Stocks (Trade Republic)","","ST Stocks","","Pasivos > Activos financieros > ST Stocks","08/03/2025","21:12","","-53,90","EUR","","Pablo; ","940,26"
"","","ST Stocks (Trade Republic)","","ST Stocks","","Pasivos > Activos financieros > ST Stocks","28/02/2025","7:55","","-28,14","EUR","","Pablo; ","994,16"
"","","ST Stocks (Trade Republic)","","ST Stocks","","Pasivos > Activos financieros > ST Stocks","14/02/2025","20:55","","20,47","EUR","","Pablo; ","1022,30"
"","","ST Stocks (Trade Republic)","","ST Stocks","","Pasivos > Activos financieros > ST Stocks","31/01/2025","20:55","","-23,00","EUR","","Pablo; ","1001,83"
"","","ST Stocks (Trade Republic)","","ST Stocks","","Inversiones Ingresos > ST Stocks","27/01/2025","9:03","","251,00","EUR","","Pablo; ","1024,83"
"","","ST Stocks (Trade Republic)","","ST Stocks","","Pasivos > Activos financieros > ST Stocks","26/01/2025","21:15","","4,17","EUR","","Pablo; ","773,83"
"","","ST Stocks (Trade Republic)","","ST Stocks","","Pasivos > Activos financieros > ST Stocks","18/01/2025","10:23","","18,69","EUR","","Pablo; ","769,66"
"","","ST Stocks (Trade Republic)","","ST Stocks","","Inversiones Ingresos > ST Stocks","13/01/2025","21:19","","-9,03","EUR","","Pablo; ","750,97"
"","","ST Stocks (Trade Republic)","","ST Stocks","","Inversiones Ingresos > ST Stocks","13/01/2025","16:10","","760,00","EUR","","Pablo; ","760,00"
"ST Stocks","1343,52","EUR","","","","","","","","","","","",""
"","","ST Stocks","","St Stocks","","Pasivos > Activos financieros > ST Stocks","11/05/2025","11:43","","138,84","EUR","","Pablo; ","1343,52"
"","","ST Stocks","","Dividendos","","Pasivos > Activos financieros > Dividendos","09/05/2025","19:53","","4,63","EUR","","Pablo; ","1204,68"
"","","ST Stocks","","Dividendos","","Pasivos > Activos financieros > Dividendos","06/05/2025","22:56","","1,23","EUR","","Pablo; ","1200,05"
"","","ST Stocks","","St Stocks","","Pasivos > Activos financieros > ST Stocks","30/04/2025","23:53","","-11,57","EUR","","Pablo; ","1198,82"
"","","ST Stocks","","Dividendos","","Pasivos > Activos financieros > Dividendos","30/04/2025","0:27","","1,78","EUR","","Pablo; ","1210,39"
"","","ST Stocks","","St Stocks","","Pasivos > Activos financieros > ST Stocks","27/04/2025","9:40","","75,44","EUR","","Pablo; ","1208,61"
"","","ST Stocks","","St Stocks","","Pasivos > Activos financieros > ST Stocks","13/04/2025","22:40","","-181,74","EUR","","Pablo; ","1133,17"
"","","ST Stocks","","ST Stocks","","Inversiones Ingresos > ST Stocks","07/04/2025","20:24","","500,00","EUR","","Pablo; ","1314,91"
"","","ST Stocks","","Dividendos","","Pasivos > Activos financieros > Dividendos","31/03/2025","0:26","","10,72","EUR","","Pablo; ","814,91"
"","","ST Stocks","","St Stocks","","Pasivos > Activos financieros > ST Stocks","30/03/2025","14:03","","-13,73","EUR","","Pablo; ","804,19"
"","","ST Stocks","","St Stocks","","Pasivos > Activos financieros > ST Stocks","23/03/2025","8:18","","43,98","EUR","","Pablo; ","817,92"
"","","ST Stocks","","St Stocks","","Pasivos > Activos financieros > ST Stocks","15/03/2025","23:03","","-82,36","EUR","","Pablo; ","773,94"
"","","ST Stocks","","St Stocks","","Pasivos > Activos financieros > ST Stocks","08/03/2025","21:21","","49,94","EUR","","Pablo; ","856,30"
"","","ST Stocks","","St Stocks","","Pasivos > Activos financieros > ST Stocks","28/02/2025","8:30","","-181,86","EUR","","Pablo; ","806,36"
"","","ST Stocks","","Dividendos","","Pasivos > Activos financieros > Dividendos","28/02/2025","0:23","","11,19","EUR","","Pablo; ","988,22"
"","","ST Stocks","","Comisiones","","Pasivos > Activos financieros > ST Stocks","18/02/2025","11:37","","-3,37","EUR","","Pablo; ","977,03"
"","","ST Stocks","","ST Stocks","","Inversiones Ingresos > ST Stocks","18/02/2025","11:35","","498,00","EUR","","Pablo; ","980,40"
"","","ST Stocks","","ST Stocks","","Pasivos > Activos financieros > ST Stocks","14/02/2025","20:52","","-58,33","EUR","","Pablo; ","482,40"
"","","ST Stocks","","ST Stocks","","Pasivos > Activos financieros > ST Stocks","31/01/2025","20:52","","-13,85","EUR","","Pablo; ","540,73"
"","","ST Stocks","","Dividendos","","Pasivos > Activos financieros > Dividendos","31/01/2025","0:21","","0,81","EUR","","Pablo; ","554,58"
"","","ST Stocks","","ST Stocks","","Pasivos > Activos financieros > ST Stocks","26/01/2025","21:16","","1,75","EUR","","Pablo; ","553,77"
"","","ST Stocks","","ST Stocks","","Pasivos > Activos financieros > ST Stocks","18/01/2025","10:24","","66,07","EUR","","Pablo; ","552,02"
"","","ST Stocks","","ST Stocks","","Pasivos > Activos financieros > ST Stocks","12/01/2025","10:53","","-0,20","EUR","","Pablo; ","485,95"
"","","ST Stocks","","ST Stocks","","Pasivos > Activos financieros > ST Stocks","05/01/2025","9:47","","16,84","EUR","","Pablo; ","486,15"
"","","ST Stocks","","Dividendos","","Pasivos > Activos financieros > Dividendos","31/12/2024","0:20","","1,06","EUR","","Pablo; ","469,31"
"","","ST Stocks","","ST Stocks","","Pasivos > Activos financieros > ST Stocks","28/12/2024","19:32","","1,87","EUR","","Pablo; ","468,25"
"","","ST Stocks","","ST Stocks","","Pasivos > Activos financieros > ST Stocks","22/12/2024","21:42","","-29,60","EUR","","Pablo; ","466,38"
"","","ST Stocks","","ST Stocks","","Pasivos > Activos financieros > ST Stocks","15/12/2024","9:38","","-9,05","EUR","","Pablo; ","495,98"
"","","ST Stocks","","ST Stocks","","Pasivos > Activos financieros > ST Stocks","09/12/2024","22:53","","11,93","EUR","","Pablo; ","505,03"
"","","ST Stocks","","ST Stocks","","Pasivos > Activos financieros > ST Stocks","02/12/2024","18:01","","19,95","EUR","","Pablo; ","493,10"
"","","ST Stocks","","Dividendos","","Pasivos > Activos financieros > Dividendos","30/11/2024","0:19","","0,54","EUR","","Pablo; ","473,15"
"","","ST Stocks","","ST Stocks","","Pasivos > Activos financieros > ST Stocks","24/11/2024","20:03","","3,86","EUR","","Pablo; ","472,61"
"","","ST Stocks","","ST Stocks","","Pasivos > Activos financieros > ST Stocks","17/11/2024","20:09","","-24,42","EUR","","Pablo; ","468,75"
"","","ST Stocks","","ST Stocks","","Pasivos > Activos financieros > ST Stocks","09/11/2024","13:51","","21,87","EUR","","Pablo; ","493,17"
"","","ST Stocks","","ST Stocks","","Pasivos > Activos financieros > ST Stocks","01/11/2024","19:00","","12,66","EUR","","Pablo; ","471,30"
"","","ST Stocks","","Dividendos","","Pasivos > Activos financieros > Dividendos","31/10/2024","0:18","","0,21","EUR","","Pablo; ","458,64"
"","","ST Stocks","","ST Stocks","","Pasivos > Activos financieros > ST Stocks","27/10/2024","19:31","","-13,98","EUR","","Pablo; ","458,43"
"","","ST Stocks","","ST Stocks","","Pasivos > Activos financieros > ST Stocks","19/10/2024","15:41","","-1,93","EUR","","Pablo; ","472,41"
"","","ST Stocks","","ST Stocks","","Pasivos > Activos financieros > ST Stocks","12/10/2024","22:02","","3,09","EUR","","Pablo; ","474,34"
"","","ST Stocks","","ST Stocks","","Pasivos > Activos financieros > ST Stocks","05/10/2024","15:13","","13,85","EUR","","Pablo; ","471,25"
"","","ST Stocks","","ST Stocks","","Pasivos > Activos financieros > ST Stocks","30/09/2024","12:29","","11,48","EUR","","Pablo; ","457,40"
"","","ST Stocks","","Dividendos","","Pasivos > Activos financieros > Dividendos","30/09/2024","0:17","","0,05","EUR","","Pablo; ","445,92"
"","","ST Stocks","","ST Stocks","","Pasivos > Activos financieros > ST Stocks","21/09/2024","19:19","","21,34","EUR","","Pablo; ","445,87"
"","","ST Stocks","","ST Stocks","","Pasivos > Activos financieros > ST Stocks","14/09/2024","7:11","","18,34","EUR","","Pablo; ","424,53"
"","","ST Stocks","","ST Stocks","","Pasivos > Activos financieros > ST Stocks","08/09/2024","11:10","","-35,95","EUR","","Pablo; ","406,19"
"","","ST Stocks","","Dividendos","","Pasivos > Activos financieros > Dividendos","31/08/2024","0:16","","0,63","EUR","","Pablo; ","442,14"
"","","ST Stocks","","ST Stocks","","Pasivos > Activos financieros > ST Stocks","30/08/2024","17:59","","-6,09","EUR","","Pablo; ","441,51"
"","","ST Stocks","","ST Stocks","","Pasivos > Activos financieros > ST Stocks","21/08/2024","22:02","","0,03","EUR","","Pablo; ","447,60"
"","","ST Stocks","","ST Stocks","","Pasivos > Activos financieros > ST Stocks","16/08/2024","22:31","","0,99","EUR","","Pablo; ","447,57"
"","","ST Stocks","","ST Stocks","","Pasivos > Activos financieros > ST Stocks","15/08/2024","19:20","","3,69","EUR","","Pablo; ","446,58"
"","","ST Stocks","","ST Stocks","","Pasivos > Activos financieros > ST Stocks","15/08/2024","17:40","","0,84","EUR","","Pablo; ","442,89"
"","","ST Stocks","","ST Stocks","","Pasivos > Activos financieros > ST Stocks","15/08/2024","16:10","","1,88","EUR","","Pablo; ","442,05"
"","","ST Stocks","","ST Stocks","","Pasivos > Activos financieros > ST Stocks","13/08/2024","15:48","","0,44","EUR","","Pablo; ","440,17"
"","","ST Stocks","","ST Stocks","","Pasivos > Activos financieros > ST Stocks","11/08/2024","21:53","","4,06","EUR","","Pablo; ","439,73"
"","","ST Stocks","","ST Stocks","","Inversiones Ingresos > ST Stocks","05/08/2024","22:02","","359,06","EUR","","Pablo; ","435,67"
"","","ST Stocks","","ST Stocks","","Pasivos > Activos financieros > ST Stocks","05/08/2024","14:14","","0,54","EUR","","Pablo; ","76,61"
"","","ST Stocks","","ST Stocks","","Pasivos > Activos financieros > ST Stocks","30/06/2024","12:14","","-1,84","EUR","","Pablo; ","76,07"
"","","ST Stocks","","Dividendos","","Pasivos > Activos financieros > Dividendos","30/06/2024","0:14","","0,01","EUR","","Pablo; ","77,91"
"","","ST Stocks","","ST Stocks","","Pasivos > Activos financieros > ST Stocks","27/06/2024","8:02","","5,22","EUR","","Pablo; ","77,90"
"","","ST Stocks","","ST Stocks","","Inversiones Ingresos > ST Stocks","24/06/2024","8:03","","18,70","EUR","","Pablo; ","72,68"
"","","ST Stocks","","Dividendos","","Pasivos > Activos financieros > Dividendos","31/05/2024","0:13","","0,01","EUR","","Pablo; ","53,98"
"","","ST Stocks","","ST Stocks","","Pasivos > Activos financieros > ST Stocks","07/04/2024","8:59","","1,27","EUR","","Pablo; ","53,97"
"","","ST Stocks","","ST Stocks","","Pasivos > Activos financieros > ST Stocks","07/04/2024","8:59","","0,50","EUR","","Pablo; ","52,70"
"","","ST Stocks","","ST Stocks","","Pasivos > Activos financieros > ST Stocks","03/03/2024","8:59","","0,56","EUR","","Pablo; ","52,20"
"","","ST Stocks","","ST Stocks","","Pasivos > Activos financieros > ST Stocks","29/02/2024","23:50","","0,59","EUR","","Pablo; ","51,64"
"","","ST Stocks","","Dividendos","","Pasivos > Activos financieros > Dividendos","29/02/2024","9:12","","0,02","EUR","","Pablo; ","51,05"
"","","ST Stocks","","ST Stocks","","Pasivos > Activos financieros > ST Stocks","24/02/2024","13:30","","0,48","EUR","","Pablo; ","51,03"
"","","ST Stocks","","ST Stocks","","Pasivos > Activos financieros > ST Stocks","17/02/2024","9:18","","0,09","EUR","","Pablo; ","50,55"
"","","ST Stocks","","ST Stocks","","Pasivos > Activos financieros > ST Stocks","10/02/2024","7:52","","4,10","EUR","","Pablo; ","50,46"
"","","ST Stocks","","ST Stocks","","Inversiones Ingresos > ST Stocks","03/02/2024","8:03","","46,36","EUR","","Pablo; ","46,36"
"","","ST Stocks","","ST Stocks","","Inversiones Ingresos > ST Stocks","19/11/2023","21:03","","-419,29","EUR","","","0,00"
"","","ST Stocks","","ST Stocks","","Pasivos > Activos financieros > ST Stocks","05/11/2023","13:28","","-25,18","EUR","","Pablo; ","419,29"
"","","ST Stocks","","ST Stocks","","Pasivos > Activos financieros > ST Stocks","05/11/2023","13:28","","-46,77","EUR","","Pablo; ","444,47"
"","","ST Stocks","","ST Stocks","","Pasivos > Activos financieros > ST Stocks","31/10/2023","20:18","","-12,36","EUR","","Pablo; ","491,24"
"","","ST Stocks","","ST Stocks","","Pasivos > Activos financieros > ST Stocks","29/10/2023","11:55","","5,60","EUR","","Pablo; ","503,60"
"","","ST Stocks","","ST Stocks","","Inversiones Ingresos > ST Stocks","25/10/2023","0:40","","498,00","EUR","","Pablo; ","498,00"
"DT Bots Cripto","347,36","EUR","","","","","","","","","","","",""
"","","DT Bots Cripto","","DT Criptos","","Pasivos > Activos financieros > DT Criptos","11/05/2025","11:44","","84,66","EUR","","Pablo; ","347,36"
"","","DT Bots Cripto","","DT Criptos","","Pasivos > Activos financieros > DT Criptos","30/04/2025","20:02","","25,67","EUR","","Pablo; ","262,70"
"","","DT Bots Cripto","","DT Criptos","","Pasivos > Activos financieros > DT Criptos","13/04/2025","20:02","","-38,12","EUR","","Pablo; ","237,03"
"","","DT Bots Cripto","","DT Criptos","","Pasivos > Activos financieros > DT Criptos","30/03/2025","14:02","","-20,28","EUR","","Pablo; ","275,15"
"","","DT Bots Cripto","","DT Criptos","","Pasivos > Activos financieros > DT Criptos","23/03/2025","8:18","","9,21","EUR","","Pablo; ","295,43"
"","","DT Bots Cripto","","DT Criptos","","Pasivos > Activos financieros > DT Criptos","15/03/2025","23:05","","-32,48","EUR","","Pablo; ","286,22"
"","","DT Bots Cripto","","DT Criptos","","Pasivos > Activos financieros > DT Criptos","08/03/2025","21:22","","-0,98","EUR","","Pablo; ","318,70"
"","","DT Bots Cripto","","DT Criptos","","Pasivos > Activos financieros > DT Criptos","28/02/2025","8:16","","-62,08","EUR","","Pablo; ","319,68"
"","","DT Bots Cripto","","DT Criptos","","Pasivos > Activos financieros > DT Criptos","14/02/2025","21:16","","-55,50","EUR","","Pablo; ","381,76"
"","","DT Bots Cripto","","DT Criptos","","Pasivos > Activos financieros > DT Criptos","26/01/2025","21:16","","-3,34","EUR","","Pablo; ","437,26"
"","","DT Bots Cripto","","DT Criptos","","Pasivos > Activos financieros > DT Criptos","18/01/2025","10:25","","4,84","EUR","","Pablo; ","440,60"
"","","DT Bots Cripto","","DT Criptos","","Pasivos > Activos financieros > DT Criptos","12/01/2025","10:54","","-28,34","EUR","","Pablo; ","435,76"
"","","DT Bots Cripto","","DT Criptos","","Pasivos > Activos financieros > DT Criptos","05/01/2025","9:48","","24,20","EUR","","Pablo; ","464,10"
"","","DT Bots Cripto","","DT Criptos","","Inversiones Ingresos > DT Criptos","04/01/2025","15:40","","29,67","EUR","","Pablo; ","439,90"
"","","DT Bots Cripto","","DT Criptos","","Pasivos > Activos financieros > DT Criptos","28/12/2024","19:33","","0,21","EUR","","Pablo; ","410,23"
"","","DT Bots Cripto","","DT Criptos","","Pasivos > Activos financieros > DT Criptos","22/12/2024","21:43","","-9,86","EUR","","Pablo; ","410,02"
"","","DT Bots Cripto","","DT Criptos","","Pasivos > Activos financieros > DT Criptos","15/12/2024","9:36","","12,34","EUR","","Pablo; ","419,88"
"","","DT Bots Cripto","","DT Criptos","","Pasivos > Activos financieros > DT Criptos","09/12/2024","22:53","","-0,83","EUR","","Pablo; ","407,54"
"","","DT Bots Cripto","","DT Criptos","","Pasivos > Activos financieros > DT Criptos","02/12/2024","17:57","","-0,05","EUR","","Pablo; ","408,37"
"","","DT Bots Cripto","","DT Criptos","","Pasivos > Activos financieros > DT Criptos","24/11/2024","20:02","","1,02","EUR","","Pablo; ","408,42"
"","","DT Bots Cripto","","DT Criptos","","Pasivos > Activos financieros > DT Criptos","17/11/2024","20:10","","20,57","EUR","","Pablo; ","407,40"
"","","DT Bots Cripto","","DT Criptos","","Pasivos > Activos financieros > DT Criptos","10/11/2024","14:54","","6,16","EUR","","Pablo; ","386,83"
"","","DT Bots Cripto","","DT Criptos","","Pasivos > Activos financieros > DT Criptos","09/11/2024","13:50","","18,42","EUR","","Pablo; ","380,67"
"","","DT Bots Cripto","","DT Criptos","","Pasivos > Activos financieros > DT Criptos","01/11/2024","18:59","","11,64","EUR","","Pablo; ","362,25"
"","","DT Bots Cripto","","DT Criptos","","Pasivos > Activos financieros > DT Criptos","27/10/2024","19:30","","-6,19","EUR","","Pablo; ","350,61"
"","","DT Bots Cripto","","DT Criptos","","Pasivos > Activos financieros > DT Criptos","19/10/2024","15:14","","19,56","EUR","","Pablo; ","356,80"
"","","DT Bots Cripto","","DT Criptos","","Pasivos > Activos financieros > DT Criptos","05/10/2024","15:14","","-3,02","EUR","","Pablo; ","337,24"
"","","DT Bots Cripto","","DT Criptos","","Pasivos > Activos financieros > DT Criptos","28/09/2024","12:31","","6,73","EUR","","Pablo; ","340,26"
"","","DT Bots Cripto","","DT Criptos","","Inversiones Ingresos > DT Criptos","24/09/2024","20:52","","40,00","EUR","","Pablo; ","333,53"
"","","DT Bots Cripto","","DT Criptos","","Pasivos > Activos financieros > DT Criptos","21/09/2024","19:16","","6,69","EUR","","Pablo; ","293,53"
"","","DT Bots Cripto","","DT Criptos","","Pasivos > Activos financieros > DT Criptos","14/09/2024","22:23","","15,78","EUR","","Pablo; ","286,84"
"","","DT Bots Cripto","","DT Criptos","","Pasivos > Activos financieros > DT Criptos","08/09/2024","10:56","","-11,40","EUR","","Pablo; ","271,06"
"","","DT Bots Cripto","","DT Criptos","","Inversiones Ingresos > DT Criptos","03/09/2024","7:58","","29,63","EUR","","Pablo; ","282,46"
"","","DT Bots Cripto","","DT Criptos","","Pasivos > Activos financieros > DT Criptos","30/08/2024","18:01","","-5,50","EUR","","Pablo; ","252,83"
"","","DT Bots Cripto","","DT Criptos","","Pasivos > Activos financieros > DT Criptos","25/08/2024","11:10","","0,10","EUR","","Pablo; ","258,33"
"","","DT Bots Cripto","","DT Criptos","","Inversiones Ingresos > DT Criptos","23/08/2024","12:56","","258,23","EUR","","Pablo; ","258,23"
"","","DT Bots Cripto","","DT Criptos","","Inversiones Ingresos > DT Criptos","07/01/2024","10:59","","-11,55","EUR","","Pablo; ","0,00"
"","","DT Bots Cripto","","DT Criptos","","Pasivos > Activos financieros > DT Criptos","07/01/2024","10:59","","0,68","EUR","","Pablo; ","11,55"
"","","DT Bots Cripto","","DT Criptos","","Inversiones Ingresos > DT Criptos","29/12/2023","20:40","","10,87","EUR","","Pablo; ","10,87"
"","","DT Bots Cripto","","DT Criptos","","Inversiones Ingresos > DT Criptos","08/12/2023","23:49","","-83,32","EUR","","Pablo; ","0,00"
"","","DT Bots Cripto","","DT Criptos","","Pasivos > Activos financieros > DT Criptos","08/12/2023","23:49","","-1,12","EUR","","Pablo; ","83,32"
"","","DT Bots Cripto","","DT Criptos","","Pasivos > Activos financieros > DT Criptos","30/11/2023","22:52","","10,34","EUR","","Pablo; ","84,44"
"","","DT Bots Cripto","","DT Criptos","","Inversiones Ingresos > DT Criptos","26/11/2023","20:40","","53,97","EUR","","Pablo; ","74,10"
"","","DT Bots Cripto","","DT Criptos","","Inversiones Ingresos > DT Criptos","26/11/2023","19:59","","-72,17","EUR","","Pablo; ","20,13"
"","","DT Bots Cripto","","DT Criptos","","Pasivos > Activos financieros > DT Criptos","26/11/2023","19:59","","1,20","EUR","","Pablo; ","92,30"
"","","DT Bots Cripto","","DT Criptos","","Pasivos > Activos financieros > DT Criptos","19/11/2023","21:14","","-2,91","EUR","","Pablo; ","91,10"
"","","DT Bots Cripto","","DT Criptos","","Inversiones Ingresos > DT Criptos","12/11/2023","11:58","","94,01","EUR","","Pablo; ","94,01"
"","","DT Bots Cripto","","DT Criptos","","Inversiones Ingresos > DT Criptos","12/11/2023","11:55","","-967,78","EUR","","Pablo; ","0,00"
"","","DT Bots Cripto","","DT Criptos","","Pasivos > Activos financieros > DT Criptos","12/11/2023","11:55","","-2,84","EUR","","Pablo; ","967,78"
"","","DT Bots Cripto","","DT Criptos","","Inversiones Ingresos > DT Criptos","05/11/2023","19:41","","970,62","EUR","","Pablo; ","970,62"
"","","DT Bots Cripto","","DT Criptos","","Inversiones Ingresos > DT Criptos","04/11/2023","21:37","","-761,15","EUR","","Pablo; ","0,00"
"","","DT Bots Cripto","","DT Criptos","","Pasivos > Activos financieros > DT Criptos","04/11/2023","21:37","","-7,42","EUR","","Pablo; ","761,15"
"","","DT Bots Cripto","","DT Criptos","","Inversiones Ingresos > DT Criptos","02/11/2023","20:36","","768,57","EUR","","Pablo; ","768,57"
"","","DT Bots Cripto","","DT Criptos","","Inversiones Ingresos > DT Criptos","02/11/2023","16:24","","-108,06","EUR","","Pablo; ","-0,00"
"","","DT Bots Cripto","","DT Criptos","","Pasivos > Activos financieros > DT Criptos","02/11/2023","16:24","","-0,52","EUR","","Pablo; ","108,06"
"","","DT Bots Cripto","","DT Criptos","","Inversiones Ingresos > DT Criptos","01/11/2023","21:20","","108,58","EUR","","Pablo; ","108,58"
"","","DT Bots Cripto","","DT Criptos","","Inversiones Ingresos > DT Criptos","01/11/2023","19:27","","-108,58","EUR","","Pablo; ","-0,00"
"","","DT Bots Cripto","","DT Criptos","","Pasivos > Activos financieros > DT Criptos","01/11/2023","19:27","","0,18","EUR","","Pablo; ","108,58"
"","","DT Bots Cripto","","DT Criptos","","Inversiones Ingresos > DT Criptos","01/11/2023","17:29","","108,40","EUR","","Pablo; ","108,40"
"","","DT Bots Cripto","","DT Criptos","","Inversiones Ingresos > DT Criptos","01/11/2023","17:27","","-108,40","EUR","","Pablo; ","-0,00"
"","","DT Bots Cripto","","DT Criptos","","Pasivos > Activos financieros > DT Criptos","01/11/2023","17:27","","0,80","EUR","","Pablo; ","108,40"
"","","DT Bots Cripto","","DT Criptos","","Inversiones Ingresos > DT Criptos","01/11/2023","7:06","","107,60","EUR","","Pablo; ","107,60"
"","","DT Bots Cripto","","DT Criptos","","Inversiones Ingresos > DT Criptos","01/11/2023","7:04","","-107,60","EUR","","Pablo; ","-0,00"
"","","DT Bots Cripto","","DT Criptos","","Pasivos > Activos financieros > DT Criptos","01/11/2023","7:01","","-0,50","EUR","","Pablo; ","107,60"
"","","DT Bots Cripto","","DT Criptos","","Pasivos > Activos financieros > DT Criptos","31/10/2023","20:20","","1,30","EUR","","Pablo; ","108,10"
"","","DT Bots Cripto","","DT Criptos","","Inversiones Ingresos > DT Criptos","30/10/2023","13:25","","-70,62","EUR","","Pablo; ","106,80"
"","","DT Bots Cripto","","DT Criptos","","Pasivos > Activos financieros > DT Criptos","30/10/2023","13:25","","0,17","EUR","","Pablo; ","177,42"
"","","DT Bots Cripto","","DT Criptos","","Inversiones Ingresos > DT Criptos","30/10/2023","9:02","","106,80","EUR","","Pablo; ","177,25"
"","","DT Bots Cripto","","DT Criptos","","Inversiones Ingresos > DT Criptos","25/10/2023","0:28","","70,45","EUR","","Pablo; ","70,45"
"","","DT Bots Cripto","","DT Criptos","","Inversiones Ingresos > DT Criptos","25/10/2023","0:26","","-605,60","EUR","","Pablo; ","-0,00"
"","","DT Bots Cripto","","DT Criptos","","Pasivos > Activos financieros > DT Criptos","25/10/2023","0:26","","-10,52","EUR","","Pablo; ","605,60"
"","","DT Bots Cripto","","DT Criptos","","Inversiones Ingresos > DT Criptos","25/10/2023","0:25","","616,12","EUR","","Pablo; ","616,12"
"","","DT Bots Cripto","","DT Criptos","","Inversiones Ingresos > DT Criptos","21/10/2023","23:58","","-585,76","EUR","","Pablo; ","-0,00"
"","","DT Bots Cripto","","DT Criptos","","Pasivos > Activos financieros > DT Criptos","21/10/2023","23:53","","0,83","EUR","","Pablo; ","585,76"
"","","DT Bots Cripto","","DT Criptos","","Inversiones Ingresos > DT Criptos","21/10/2023","23:52","","584,93","EUR","","Pablo; ","584,93"
"","","DT Bots Cripto","","DT Criptos","","Inversiones Ingresos > DT Criptos","05/10/2023","23:38","","-175,63","EUR","","Pablo; ","-0,00"
"","","DT Bots Cripto","","DT Criptos","","Pasivos > Activos financieros > DT Criptos","05/10/2023","23:37","","-6,98","EUR","","Pablo; ","175,63"
"","","DT Bots Cripto","","DT Criptos","","Inversiones Ingresos > DT Criptos","05/10/2023","23:36","","182,61","EUR","","Pablo; ","182,61"
"","","DT Bots Cripto","","DT Criptos","","Inversiones Ingresos > DT Criptos","01/10/2023","23:37","","-93,80","EUR","","Pablo; ","-0,00"
"","","DT Bots Cripto","","DT Criptos","","Pasivos > Activos financieros > DT Criptos","01/10/2023","23:37","","3,15","EUR","","Pablo; ","93,80"
"","","DT Bots Cripto","","DT Criptos","","Inversiones Ingresos > DT Criptos","01/10/2023","23:36","","90,65","EUR","","Pablo; ","90,65"
"","","DT Bots Cripto","","DT Criptos","","Inversiones Ingresos > DT Criptos","01/10/2023","23:36","","-52,39","EUR","","Pablo; ","-0,00"
"","","DT Bots Cripto","","DT Criptos","","Pasivos > Activos financieros > DT Criptos","01/10/2023","23:35","","-1,68","EUR","","Pablo; ","52,39"
"","","DT Bots Cripto","","DT Criptos","","Inversiones Ingresos > DT Criptos","01/10/2023","23:35","","54,07","EUR","","Pablo; ","54,07"
"Urbanitae","1000,00","EUR","","","","","","","","","","","",""
"","","Urbanitae","","Crowdfunding Inm.","","Inversiones Ingresos > Crowdfunding Inm.","23/03/2025","8:01","","475,00","EUR","","Pablo; ","1000,00"
"","","Urbanitae","","Referido","","Pasivos > Activos financieros > Crowdlending","11/03/2025","18:20","","25,00","EUR","","Pablo; ","525,00"
"","","Urbanitae","","Crowdfunding Inm.","","Inversiones Ingresos > Crowdfunding Inm.","01/01/2025","19:59","","500,00","EUR","","Pablo; ","500,00"
"Crowdlending ViaInvest","923,05","EUR","","","","","","","","","","","",""
"","","Crowdlending ViaInvest","","Crowdlending","","Inversiones Ingresos > Crowdlending","12/05/2025","19:38","","153,91","EUR","","Pablo; ","923,05"
"","","Crowdlending ViaInvest","","Crowdlending","","Inversiones Ingresos > Crowdlending","11/05/2025","18:05","","25,00","EUR","","Pablo; ","769,14"
"","","Crowdlending ViaInvest","","Intereses Crowdlending","","Pasivos > Activos financieros > Crowdlending","11/05/2025","11:11","","2,43","EUR","","Pablo; ","744,14"
"","","Crowdlending ViaInvest","","Crowdlending","","Inversiones Ingresos > Crowdlending","06/05/2025","23:20","","25,00","EUR","","Pablo; ","741,71"
"","","Crowdlending ViaInvest","","Crowdlending","","Inversiones Ingresos > Crowdlending","01/05/2025","23:29","","25,00","EUR","","Pablo; ","716,71"
"","","Crowdlending ViaInvest","","Intereses Crowdlending","","Pasivos > Activos financieros > Crowdlending","30/04/2025","22:41","","3,29","EUR","","Pablo; ","691,71"
"","","Crowdlending ViaInvest","","Crowdlending","","Inversiones Ingresos > Crowdlending","13/04/2025","22:57","","30,00","EUR","","Pablo; ","688,42"
"","","Crowdlending ViaInvest","","Intereses Crowdlending","","Pasivos > Activos financieros > Crowdlending","13/04/2025","22:41","","2,40","EUR","","Pablo; ","658,42"
"","","Crowdlending ViaInvest","","Crowdlending","","Inversiones Ingresos > Crowdlending","07/04/2025","19:24","","60,00","EUR","","Pablo; ","656,02"
"","","Crowdlending ViaInvest","","Intereses Crowdlending","","Pasivos > Activos financieros > Crowdlending","30/03/2025","13:37","","1,25","EUR","","Pablo; ","596,02"
"","","Crowdlending ViaInvest","","Intereses Crowdlending","","Pasivos > Activos financieros > Crowdlending","23/03/2025","8:20","","1,25","EUR","","Pablo; ","594,77"
"","","Crowdlending ViaInvest","","Crowdlending","","Inversiones Ingresos > Crowdlending","23/03/2025","8:12","","30,00","EUR","","Pablo; ","593,52"
"","","Crowdlending ViaInvest","","Crowdlending","","Inversiones Ingresos > Crowdlending","17/03/2025","22:43","","30,00","EUR","","Pablo; ","563,52"
"","","Crowdlending ViaInvest","","Intereses Crowdlending","","Pasivos > Activos financieros > Crowdlending","15/03/2025","22:44","","1,04","EUR","","Pablo; ","533,52"
"","","Crowdlending ViaInvest","","Crowdlending","","Inversiones Ingresos > Crowdlending","11/03/2025","0:22","","30,00","EUR","","Pablo; ","532,48"
"","","Crowdlending ViaInvest","","Intereses Crowdlending","","Pasivos > Activos financieros > Crowdlending","08/03/2025","21:25","","1,07","EUR","","Pablo; ","502,48"
"","","Crowdlending ViaInvest","","Crowdlending","","Inversiones Ingresos > Crowdlending","05/03/2025","22:12","","30,00","EUR","","Pablo; ","501,41"
"","","Crowdlending ViaInvest","","Intereses Crowdlending","","Pasivos > Activos financieros > Crowdlending","28/02/2025","8:33","","1,66","EUR","","Pablo; ","471,41"
"","","Crowdlending ViaInvest","","Crowdlending","","Inversiones Ingresos > Crowdlending","24/02/2025","13:42","","30,00","EUR","","Pablo; ","469,75"
"","","Crowdlending ViaInvest","","Crowdlending","","Inversiones Ingresos > Crowdlending","16/02/2025","0:10","","25,00","EUR","","Pablo; ","439,75"
"","","Crowdlending ViaInvest","","Intereses Crowdlending","","Pasivos > Activos financieros > Crowdlending","15/02/2025","0:24","","1,55","EUR","","Pablo; ","414,75"
"","","Crowdlending ViaInvest","","Crowdlending","","Inversiones Ingresos > Crowdlending","03/02/2025","0:44","","30,00","EUR","","Pablo; ","413,20"
"","","Crowdlending ViaInvest","","Intereses Crowdlending","","Pasivos > Activos financieros > Crowdlending","31/01/2025","20:57","","0,65","EUR","","Pablo; ","383,20"
"","","Crowdlending ViaInvest","","Intereses Crowdlending","","Pasivos > Activos financieros > Crowdlending","26/01/2025","21:17","","0,70","EUR","","Pablo; ","382,55"
"","","Crowdlending ViaInvest","","Crowdlending","","Inversiones Ingresos > Crowdlending","26/01/2025","21:12","","27,00","EUR","","Pablo; ","381,85"
"","","Crowdlending ViaInvest","","Intereses Crowdlending","","Pasivos > Activos financieros > Crowdlending","18/01/2025","10:25","","0,56","EUR","","Pablo; ","354,85"
"","","Crowdlending ViaInvest","","Crowdlending","","Inversiones Ingresos > Crowdlending","18/01/2025","10:21","","25,00","EUR","","Pablo; ","354,29"
"","","Crowdlending ViaInvest","","Intereses Crowdlending","","Pasivos > Activos financieros > Crowdlending","12/01/2025","10:55","","1,65","EUR","","Pablo; ","329,29"
"","","Crowdlending ViaInvest","","Intereses Crowdlending","","Pasivos > Activos financieros > Crowdlending","05/01/2025","9:48","","-0,46","EUR","","Pablo; ","327,64"
"","","Crowdlending ViaInvest","","Crowdlending","","Inversiones Ingresos > Crowdlending","01/01/2025","20:39","","25,00","EUR","","Pablo; ","328,10"
"","","Crowdlending ViaInvest","","Intereses Crowdlending","","Pasivos > Activos financieros > Crowdlending","28/12/2024","19:32","","0,52","EUR","","Pablo; ","303,10"
"","","Crowdlending ViaInvest","","Intereses Crowdlending","","Pasivos > Activos financieros > Crowdlending","22/12/2024","21:46","","0,64","EUR","","Pablo; ","302,58"
"","","Crowdlending ViaInvest","","Intereses Crowdlending","","Pasivos > Activos financieros > Crowdlending","15/12/2024","9:40","","0,56","EUR","","Pablo; ","301,94"
"","","Crowdlending ViaInvest","","Intereses Crowdlending","","Pasivos > Activos financieros > Crowdlending","09/12/2024","22:47","","0,65","EUR","","Pablo; ","301,38"
"","","Crowdlending ViaInvest","","Intereses Crowdlending","","Pasivos > Activos financieros > Crowdlending","02/12/2024","21:00","","0,73","EUR","","Pablo; ","300,73"
"","","Crowdlending ViaInvest","","Crowdlending","","Inversiones Ingresos > Crowdlending","14/11/2024","22:07","","300,00","EUR","","","300,00"
"MetaMask Lucas","112,45","EUR","","","","","","","","","","","",""
"","","MetaMask Lucas","","ST Criptos","","Pasivos > Activos financieros > ST Criptos","11/05/2025","11:41","","32,39","EUR","","Compartido; ","112,45"
"","","MetaMask Lucas","","ST Criptos","","Pasivos > Activos financieros > ST Criptos","30/04/2025","23:06","","8,54","EUR","","Compartido; ","80,06"
"","","MetaMask Lucas","","ST Criptos","","Pasivos > Activos financieros > ST Criptos","13/04/2025","23:06","","-14,07","EUR","","Compartido; ","71,52"
"","","MetaMask Lucas","","ST Criptos","","Pasivos > Activos financieros > ST Criptos","15/03/2025","23:06","","-4,67","EUR","","Compartido; ","85,59"
"","","MetaMask Lucas","","ST Criptos","","Pasivos > Activos financieros > ST Criptos","15/03/2025","23:06","","-13,24","EUR","","Compartido; ","90,26"
"","","MetaMask Lucas","","ST Criptos","","Pasivos > Activos financieros > ST Criptos","08/03/2025","21:23","","1,17","EUR","","Compartido; ","103,50"
"","","MetaMask Lucas","","ST Criptos","","Pasivos > Activos financieros > ST Criptos","28/02/2025","8:53","","-29,00","EUR","","Compartido; ","102,33"
"","","MetaMask Lucas","","ST Criptos","","Pasivos > Activos financieros > ST Criptos","15/02/2025","0:27","","1,33","EUR","","Compartido; ","131,33"
"","","MetaMask Lucas","","ST Criptos","","Inversiones Ingresos > ST Criptos","08/02/2025","9:50","","130,00","EUR","","Compartido; ","130,00"
"Bet365","0,00","EUR","","","","","","","","","","","",""
"","","Bet365","","Apuesta","","Pasivos > Activos financieros > Loterías  y apuestas","11/02/2023","23:58","","-0,36","EUR","","Pablo; ","0,00"
"","","Bet365","","Apuesta","","Pasivos > Activos financieros > Loterías  y apuestas","05/02/2023","14:55","","0,09","EUR","","Pablo; ","0,36"
"","","Bet365","","Apuesta","","Pasivos > Activos financieros > Loterías  y apuestas","28/01/2023","23:58","","-0,93","EUR","","Pablo; ","0,27"
"","","Bet365","","Apuesta","","Pasivos > Activos financieros > Loterías  y apuestas","31/12/2022","23:58","","-1,97","EUR","","","1,20"
"","","Bet365","","Apuesta","","Pasivos > Activos financieros > Loterías  y apuestas","31/10/2022","23:58","","0,51","EUR","","","3,17"
"","","Bet365","","Apuesta","","Pasivos > Activos financieros > Loterías  y apuestas","31/10/2022","23:58","","-3,32","EUR","","","2,66"
"","","Bet365","","Apuesta","","Pasivos > Activos financieros > Loterías  y apuestas","30/09/2022","23:58","","-4,19","EUR","","","5,98"
"","","Bet365","","Apuesta","","Pasivos > Activos financieros > Loterías  y apuestas","11/09/2022","23:58","","0,88","EUR","","","10,17"
"","","Bet365","","Apuesta","","Pasivos > Activos financieros > Loterías  y apuestas","28/08/2022","20:58","","1,05","EUR","","","9,29"
"","","Bet365","","Intereses","","Pasivos > Activos financieros > Loterías  y apuestas","29/05/2022","12:11","","0,43","EUR","","","8,24"
"","","Bet365","","Apuesta","","Pasivos > Activos financieros > Loterías  y apuestas","30/01/2022","20:58","","1,63","EUR","","","7,81"
"","","Bet365","","Nuevo saldo","","","24/10/2021","18:09","","-1,00","EUR","","","6,18"
"","","Bet365","","Nuevo saldo","","","30/04/2021","18:53","","-1,00","EUR","","","7,18"
"","","Bet365","","Nuevo saldo","","","01/04/2021","23:29","","-0,20","EUR","","","8,18"
"","","Bet365","","Nuevo saldo","","","01/04/2021","21:00","","8,38","EUR","","","8,38"
"","","Bet365","","Nuevo saldo","","","19/05/2018","13:35","","-11,31","EUR","","","0,00"
"ING Health Care","0,00","EUR","","","","","","","","","","","",""
"","","ING Health Care","","Fondos","","Inversiones Ingresos > Fondos","29/11/2023","19:32","","-423,64","EUR","","Pablo; ","0,00"
"","","ING Health Care","","Fondos","","Pasivos > Activos financieros > Fondos","29/11/2023","19:30","","-4,96","EUR","","Pablo; ","423,64"
"","","ING Health Care","","Fondos","","Pasivos > Activos financieros > Fondos","24/11/2023","21:42","","8,00","EUR","","Pablo; ","428,60"
"","","ING Health Care","","Fondos","","Pasivos > Activos financieros > Fondos","18/11/2023","10:08","","0,26","EUR","","Pablo; ","420,60"
"","","ING Health Care","","Fondos","","Pasivos > Activos financieros > Fondos","12/11/2023","8:42","","-2,44","EUR","","Pablo; ","420,34"
"","","ING Health Care","","Fondos","","Pasivos > Activos financieros > Fondos","05/11/2023","13:02","","10,39","EUR","","Pablo; ","422,78"
"","","ING Health Care","","Fondos","","Pasivos > Activos financieros > Fondos","31/10/2023","19:58","","-7,51","EUR","","Pablo; ","412,39"
"","","ING Health Care","","Fondos","","Pasivos > Activos financieros > Fondos","28/10/2023","12:12","","-9,05","EUR","","Pablo; ","419,90"
"","","ING Health Care","","Fondos","","Pasivos > Activos financieros > Fondos","22/10/2023","9:43","","-8,89","EUR","","Pablo; ","428,95"
"","","ING Health Care","","Fondos","","Pasivos > Activos financieros > Fondos","14/10/2023","20:03","","5,36","EUR","","Pablo; ","437,84"
"","","ING Health Care","","Fondos","","Pasivos > Activos financieros > Fondos","07/10/2023","19:13","","-3,82","EUR","","Pablo; ","432,48"
"","","ING Health Care","","Fondos","","Pasivos > Activos financieros > Fondos","30/09/2023","7:22","","1,27","EUR","","Pablo; ","436,30"
"","","ING Health Care","","Fondos","","Pasivos > Activos financieros > Fondos","24/09/2023","11:04","","-8,60","EUR","","Pablo; ","435,03"
"","","ING Health Care","","Fondos","","Pasivos > Activos financieros > Fondos","16/09/2023","0:05","","6,19","EUR","","Pablo; ","443,63"
"","","ING Health Care","","Fondos","","Pasivos > Activos financieros > Fondos","10/09/2023","22:23","","2,48","EUR","","Pablo; ","437,44"
"","","ING Health Care","","Fondos","","Pasivos > Activos financieros > Fondos","01/09/2023","23:31","","-4,55","EUR","","Pablo; ","434,96"
"","","ING Health Care","","Fondos","","Pasivos > Activos financieros > Fondos","31/08/2023","12:13","","6,65","EUR","","Pablo; ","439,51"
"","","ING Health Care","","Fondos","","Pasivos > Activos financieros > Fondos","26/08/2023","16:02","","0,28","EUR","","Pablo; ","432,86"
"","","ING Health Care","","Fondos","","Pasivos > Activos financieros > Fondos","14/08/2023","15:52","","8,54","EUR","","Pablo; ","432,58"
"","","ING Health Care","","Fondos","","Pasivos > Activos financieros > Fondos","06/08/2023","11:25","","-2,50","EUR","","Pablo; ","424,04"
"","","ING Health Care","","Fondos","","Pasivos > Activos financieros > Fondos","29/07/2023","11:40","","1,30","EUR","","Pablo; ","426,54"
"","","ING Health Care","","Fondos","","Pasivos > Activos financieros > Fondos","23/07/2023","6:06","","13,83","EUR","","Pablo; ","425,24"
"","","ING Health Care","","Fondos","","Pasivos > Activos financieros > Fondos","16/07/2023","9:46","","-11,20","EUR","","Pablo; ","411,41"
"","","ING Health Care","","Fondos","","Pasivos > Activos financieros > Fondos","09/07/2023","19:00","","-0,38","EUR","","Pablo; ","422,61"
"","","ING Health Care","","Fondos","","Pasivos > Activos financieros > Fondos","30/06/2023","7:54","","-2,36","EUR","","Pablo; ","422,99"
"","","ING Health Care","","Fondos","","Pasivos > Activos financieros > Fondos","25/06/2023","9:07","","-0,23","EUR","","Pablo; ","425,35"
"","","ING Health Care","","Fondos","","Pasivos > Activos financieros > Fondos","18/06/2023","9:03","","2,57","EUR","","Pablo; ","425,58"
"","","ING Health Care","","Fondos","","Pasivos > Activos financieros > Fondos","11/06/2023","22:36","","2,25","EUR","","Pablo; ","423,01"
"","","ING Health Care","","Fondos","","Pasivos > Activos financieros > Fondos","04/06/2023","18:18","","1,05","EUR","","Pablo; ","420,76"
"","","ING Health Care","","Fondos","","Pasivos > Activos financieros > Fondos","31/05/2023","18:43","","-0,11","EUR","","Pablo; ","419,71"
"","","ING Health Care","","Fondos","","Pasivos > Activos financieros > Fondos","28/05/2023","17:23","","-7,92","EUR","","Pablo; ","419,82"
"","","ING Health Care","","Fondos","","Pasivos > Activos financieros > Fondos","21/05/2023","13:35","","2,46","EUR","","Pablo; ","427,74"
"","","ING Health Care","","Fondos","","Pasivos > Activos financieros > Fondos","14/05/2023","21:54","","3,25","EUR","","Pablo; ","425,28"
"","","ING Health Care","","Fondos","","Pasivos > Activos financieros > Fondos","07/05/2023","11:27","","2,29","EUR","","Pablo; ","422,03"
"","","ING Health Care","","Fondos","","Pasivos > Activos financieros > Fondos","30/04/2023","14:56","","0,60","EUR","","Pablo; ","419,74"
"","","ING Health Care","","Fondos","","Pasivos > Activos financieros > Fondos","23/04/2023","19:42","","-3,59","EUR","","Pablo; ","419,14"
"","","ING Health Care","","Fondos","","Pasivos > Activos financieros > Fondos","16/04/2023","17:13","","3,74","EUR","","Pablo; ","422,73"
"","","ING Health Care","","Fondos","","Pasivos > Activos financieros > Fondos","09/04/2023","13:37","","10,01","EUR","","Pablo; ","418,99"
"","","ING Health Care","","Fondos","","Pasivos > Activos financieros > Fondos","04/04/2023","9:04","","4,98","EUR","","Pablo; ","408,98"
"","","ING Health Care","","Fondos","","Pasivos > Activos financieros > Fondos","31/03/2023","20:14","","7,95","EUR","","Pablo; ","404,00"
"","","ING Health Care","","Fondos","","Pasivos > Activos financieros > Fondos","26/03/2023","19:42","","-9,75","EUR","","Pablo; ","396,05"
"","","ING Health Care","","Fondos","","Pasivos > Activos financieros > Fondos","19/03/2023","11:58","","0,79","EUR","","Pablo; ","405,80"
"","","ING Health Care","","Fondos","","Pasivos > Activos financieros > Fondos","12/03/2023","18:05","","-3,20","EUR","","Pablo; ","405,01"
"","","ING Health Care","","Fondos","","Pasivos > Activos financieros > Fondos","05/03/2023","18:34","","-7,63","EUR","","Pablo; ","408,21"
"","","ING Health Care","","Fondos","","Pasivos > Activos financieros > Fondos","28/02/2023","21:43","","-3,05","EUR","","Pablo; ","415,84"
"","","ING Health Care","","Fondos","","Pasivos > Activos financieros > Fondos","26/02/2023","9:34","","0,67","EUR","","Pablo; ","418,89"
"","","ING Health Care","","Fondos","","Pasivos > Activos financieros > Fondos","19/02/2023","9:40","","0,88","EUR","","Pablo; ","418,22"
"","","ING Health Care","","Fondos","","Pasivos > Activos financieros > Fondos","12/02/2023","12:09","","8,45","EUR","","Pablo; ","417,34"
"","","ING Health Care","","Fondos","","Pasivos > Activos financieros > Fondos","05/02/2023","14:50","","-9,13","EUR","","Pablo; ","408,89"
"","","ING Health Care","","Fondos","","Pasivos > Activos financieros > Fondos","29/01/2023","10:28","","-1,82","EUR","","Pablo; ","418,02"
"","","ING Health Care","","Fondos","","Pasivos > Activos financieros > Fondos","22/01/2023","14:06","","-1,10","EUR","","Pablo; ","419,84"
"","","ING Health Care","","Fondos","","Pasivos > Activos financieros > Fondos","15/01/2023","16:15","","-13,03","EUR","","Pablo; ","420,94"
"","","ING Health Care","","Fondos","","Pasivos > Activos financieros > Fondos","31/12/2022","20:53","","-10,59","EUR","","","433,97"
"","","ING Health Care","","Fondos","","Pasivos > Activos financieros > Fondos","30/11/2022","20:53","","4,65","EUR","","","444,56"
"","","ING Health Care","","Fondos","","Pasivos > Activos financieros > Fondos","31/10/2022","20:53","","4,36","EUR","","","439,91"
"","","ING Health Care","","Fondos","","Pasivos > Activos financieros > Fondos","30/09/2022","20:53","","9,13","EUR","","","435,55"
"","","ING Health Care","","Fondos","","Inversiones Ingresos > Fondos","12/09/2022","20:49","","80,00","EUR","","","426,42"
"","","ING Health Care","","Fondos","","Pasivos > Activos financieros > Fondos","10/09/2022","20:53","","-0,40","EUR","","","346,42"
"","","ING Health Care","","Fondos","","Inversiones Ingresos > Fondos","10/09/2022","7:33","","298,50","EUR","","","346,82"
"","","ING Health Care","","Fondos","","Pasivos > Activos financieros > Fondos","31/08/2022","16:45","","-1,68","EUR","","","48,32"
"","","ING Health Care","","Fondos","","Inversiones Ingresos > Fondos","24/08/2022","17:42","","50,00","EUR","","","50,00"
"ING PIMCO GIS Commodity","0,00","EUR","","","","","","","","","","","",""
"","","ING PIMCO GIS Commodity","","Fondos","","Inversiones Ingresos > Fondos","03/11/2022","18:45","","-403,52","EUR","","","0,00"
"","","ING PIMCO GIS Commodity","","Intereses","","Pasivos > Activos financieros > Fondos","03/11/2022","18:44","","15,07","EUR","","","403,52"
"","","ING PIMCO GIS Commodity","","Intereses","","Pasivos > Activos financieros > Fondos","31/10/2022","16:46","","4,30","EUR","","","388,45"
"","","ING PIMCO GIS Commodity","","Intereses","","Pasivos > Activos financieros > Fondos","30/09/2022","16:46","","-36,84","EUR","","","384,15"
"","","ING PIMCO GIS Commodity","","Fondos","","Inversiones Ingresos > Fondos","12/09/2022","20:49","","80,00","EUR","","","420,99"
"","","ING PIMCO GIS Commodity","","Fondos","","Inversiones Ingresos > Fondos","10/09/2022","7:31","","292,07","EUR","","","340,99"
"","","ING PIMCO GIS Commodity","","Intereses","","Pasivos > Activos financieros > Fondos","31/08/2022","16:46","","-1,08","EUR","","","48,92"
"","","ING PIMCO GIS Commodity","","Fondos","","Inversiones Ingresos > Fondos","24/08/2022","17:43","","50,00","EUR","","","50,00"
"ING 10/90","0,00","EUR","","","","","","","","","","","",""
"","","ING 10/90","","Intereses","","Pasivos > Activos financieros > Fondos","10/09/2022","20:54","","-1,68","EUR","","","0,00"
"","","ING 10/90","","Fondos","","Inversiones Gastos > Fondos","10/09/2022","7:33","","-298,50","EUR","","","1,68"
"","","ING 10/90","","Fondos","","Inversiones Gastos > Fondos","10/09/2022","7:29","","-292,07","EUR","","","300,18"
"","","ING 10/90","","Intereses","","Pasivos > Activos financieros > Fondos","31/08/2022","7:06","","-9,05","EUR","","","592,25"
"","","ING 10/90","","Fondos","","Inversiones Ingresos > Fondos","21/08/2022","10:59","","100,00","EUR","","","601,30"
"","","ING 10/90","","Fondos","","Inversiones Ingresos > Fondos","14/08/2022","8:35","","100,00","EUR","","","501,30"
"","","ING 10/90","","Fondos","","Inversiones Ingresos > Fondos","09/08/2022","23:16","","100,00","EUR","","","401,30"
"","","ING 10/90","","Fondos","","Inversiones Ingresos > Fondos","02/08/2022","13:20","","100,00","EUR","","","301,30"
"","","ING 10/90","","Intereses","","Pasivos > Activos financieros > Fondos","31/07/2022","10:54","","1,30","EUR","","","201,30"
"","","ING 10/90","","Fondos","","Inversiones Ingresos > Fondos","28/07/2022","17:03","","100,00","EUR","","","200,00"
"","","ING 10/90","","Fondos","","Inversiones Ingresos > Fondos","19/07/2022","16:14","","100,00","EUR","","","100,00"
"ING Renta Fija","0,00","EUR","","","","","","","","","","","",""
"","","ING Renta Fija","","Fondos","","Inversiones Ingresos > Fondos","28/05/2022","7:49","","-1099,73","EUR","","","0,00"
"","","ING Renta Fija","","Intereses","","Pasivos > Activos financieros > Fondos","26/05/2022","7:55","","-2,86","EUR","","","1099,73"
"","","ING Renta Fija","","Intereses","","Pasivos > Activos financieros > Fondos","28/04/2022","7:55","","-111,29","EUR","","","1102,59"
"","","ING Renta Fija","","Fondos","","Inversiones Ingresos > Fondos","28/03/2022","7:49","","-1753,92","EUR","","","1213,88"
"","","ING Renta Fija","","Intereses","","Pasivos > Activos financieros > Fondos","28/02/2022","7:55","","-86,60","EUR","","","2967,80"
"","","ING Renta Fija","","Fondos","","Inversiones Ingresos > Fondos","05/02/2022","7:49","","200,00","EUR","","","3054,40"
"","","ING Renta Fija","","Fondos","","Inversiones Ingresos > Fondos","05/01/2022","7:49","","200,00","EUR","","","2854,40"
"","","ING Renta Fija","","Intereses","","Pasivos > Activos financieros > Fondos","30/12/2021","7:55","","7,34","EUR","","","2654,40"
"","","ING Renta Fija","","Fondos","","Inversiones Ingresos > Fondos","28/02/2021","7:49","","120,00","EUR","","","2647,06"
"","","ING Renta Fija","","Fondos","","Inversiones Ingresos > Fondos","28/01/2021","7:49","","120,00","EUR","","","2527,06"
"","","ING Renta Fija","","Intereses","","Pasivos > Activos financieros > Fondos","30/12/2020","7:55","","26,67","EUR","","","2407,06"
"","","ING Renta Fija","","Intereses","","Pasivos > Activos financieros > Fondos","30/12/2019","7:55","","45,26","EUR","","","2380,39"
"","","ING Renta Fija","","Fondos","","Inversiones Ingresos > Fondos","28/02/2019","7:49","","115,00","EUR","","","2335,13"
"","","ING Renta Fija","","Intereses","","Pasivos > Activos financieros > Fondos","30/12/2018","7:52","","-29,87","EUR","","","2220,13"
"","","ING Renta Fija","","Fondos","","Inversiones Ingresos > Fondos","28/12/2018","7:49","","75,00","EUR","","","2250,00"
"","","ING Renta Fija","","Fondos","","Inversiones Ingresos > Fondos","28/11/2018","7:49","","75,00","EUR","","","2175,00"
"","","ING Renta Fija","","Fondos","","Inversiones Ingresos > Fondos","28/10/2018","7:49","","75,00","EUR","","","2100,00"
"","","ING Renta Fija","","Fondos","","Inversiones Ingresos > Fondos","28/09/2018","7:49","","75,00","EUR","","","2025,00"
"","","ING Renta Fija","","Fondos","","Inversiones Ingresos > Fondos","28/08/2018","7:49","","75,00","EUR","","","1950,00"
"","","ING Renta Fija","","Fondos","","Inversiones Ingresos > Fondos","28/07/2018","7:49","","75,00","EUR","","","1875,00"
"","","ING Renta Fija","","Fondos","","Inversiones Ingresos > Fondos","28/06/2018","7:49","","300,00","EUR","","","1800,00"
"","","ING Renta Fija","","Fondos","","Inversiones Ingresos > Fondos","28/05/2018","7:49","","300,00","EUR","","","1500,00"
"","","ING Renta Fija","","Fondos","","Inversiones Ingresos > Fondos","28/04/2018","7:49","","300,00","EUR","","","1200,00"
"","","ING Renta Fija","","Fondos","","Inversiones Ingresos > Fondos","28/03/2018","7:49","","300,00","EUR","","","900,00"
"","","ING Renta Fija","","Fondos","","Inversiones Ingresos > Fondos","28/02/2018","7:49","","300,00","EUR","","","600,00"
"","","ING Renta Fija","","Fondos","","Inversiones Ingresos > Fondos","31/01/2018","7:49","","300,00","EUR","","","300,00"
"ING S&P","0,00","EUR","","","","","","","","","","","",""
"","","ING S&P","","Impuestos Plusvalías","","Pasivos > Activos financieros > Fondos","01/06/2022","10:09","","-52,18","EUR","","","0,00"
"","","ING S&P","","Fondos","","Inversiones Ingresos > Fondos","01/06/2022","10:05","","-1002,43","EUR","","","52,18"
"","","ING S&P","","Intereses","","Pasivos > Activos financieros > Fondos","01/06/2022","9:54","","-2,06","EUR","","","1054,61"
"","","ING S&P","","Intereses","","Pasivos > Activos financieros > Fondos","31/05/2022","9:54","","-85,27","EUR","","","1056,67"
"","","ING S&P","","Fondos","","Inversiones Ingresos > Fondos","05/02/2022","9:51","","125,00","EUR","","","1141,94"
"","","ING S&P","","Fondos","","Inversiones Ingresos > Fondos","05/01/2022","9:51","","125,00","EUR","","","1016,94"
"","","ING S&P","","Intereses","","Pasivos > Activos financieros > Fondos","31/12/2021","9:54","","193,05","EUR","","","891,94"
"","","ING S&P","","Fondos","","Inversiones Ingresos > Fondos","05/02/2021","9:51","","40,00","EUR","","","698,89"
"","","ING S&P","","Fondos","","Inversiones Ingresos > Fondos","05/01/2021","9:51","","40,00","EUR","","","658,89"
"","","ING S&P","","Intereses","","Pasivos > Activos financieros > Fondos","31/12/2020","9:54","","85,29","EUR","","","618,89"
"","","ING S&P","","Fondos","","Inversiones Ingresos > Fondos","05/01/2020","9:51","","50,00","EUR","","","533,60"
"","","ING S&P","","Intereses","","Pasivos > Activos financieros > Fondos","31/12/2019","9:54","","135,31","EUR","","","483,60"
"","","ING S&P","","Fondos","","Inversiones Ingresos > Fondos","05/01/2019","9:51","","50,00","EUR","","","348,29"
"","","ING S&P","","Intereses","","Pasivos > Activos financieros > Fondos","31/12/2018","9:54","","-51,71","EUR","","","298,29"
"","","ING S&P","","Fondos","","Inversiones Ingresos > Fondos","05/12/2018","9:51","","50,00","EUR","","","350,00"
"","","ING S&P","","Fondos","","Inversiones Ingresos > Fondos","05/11/2018","9:51","","50,00","EUR","","","300,00"
"","","ING S&P","","Fondos","","Inversiones Ingresos > Fondos","05/10/2018","9:51","","50,00","EUR","","","250,00"
"","","ING S&P","","Fondos","","Inversiones Ingresos > Fondos","05/09/2018","9:51","","50,00","EUR","","","200,00"
"","","ING S&P","","Fondos","","Inversiones Ingresos > Fondos","05/08/2018","9:51","","50,00","EUR","","","150,00"
"","","ING S&P","","Fondos","","Inversiones Ingresos > Fondos","05/07/2018","9:51","","50,00","EUR","","","100,00"
"","","ING S&P","","Fondos","","Inversiones Ingresos > Fondos","05/06/2018","9:51","","50,00","EUR","","","50,00"
